AAAACGCCGAT -> AAACGCCGATT
AAAAGCGCCCA -> AAAGCGCCCAA
AAAATCGGATT -> AAATCGGATTT
AAACACCATGG -> AACACCATGGC
AAACAGTTCTC -> AACAGTTCTCC
AAACCCAGCAA -> AACCCAGCAAA
AAACCCCGAAC -> AACCCCGAACC
AAACGAGCTTA -> AACGAGCTTAA
AAACGCCGATT -> AACGCCGATTT
AAACGGAAAGG -> AACGGAAAGGC
AAACTGAGTCC -> AACTGAGTCCG
AAAGACGGAGC -> AAGACGGAGCG
AAAGCGCCCAA -> AAGCGCCCAAG
AAAGCTCAGGG -> AAGCTCAGGGA
AAAGGCAGCAA -> AAGGCAGCAAC
AAAGGCGCAAG -> AAGGCGCAAGG
AAAGTAGGCGG -> AAGTAGGCGGG
AAAGTGTTCCG -> AAGTGTTCCGG
AAAGTTTTCGA -> AAGTTTTCGAC
AAATACTCCCA -> AATACTCCCAG
AAATAGTTGAA -> AATAGTTGAAC
AAATATATGAC -> AATATATGACT
AAATCCCTGGT -> AATCCCTGGTT
AAATCGGATTT -> AATCGGATTTG
AAATCGTCAAG -> AATCGTCAAGA
AAATCTCTGCT -> AATCTCTGCTT
AAATGCCTGCC -> AATGCCTGCCT
AAATGGTCGCT -> AATGGTCGCTC
AACAACAGGGC -> ACAACAGGGCA
AACACCATGGC -> ACACCATGGCC
AACAGGGACGG -> ACAGGGACGGC
AACAGGGCACA -> ACAGGGCACAC
AACAGGTCATG -> ACAGGTCATGC
AACAGTTCTCC -> ACAGTTCTCCT
AACATGGAGCA -> ACATGGAGCAT
AACCCAGCAAA -> ACCCAGCAAAG
AACCCCGAACC -> ACCCCGAACCC
AACCCCTGGAC -> ACCCCTGGACG
AACCGTGCGGG -> ACCGTGCGGGA
AACCTAATGCA -> ACCTAATGCAG
AACCTGCCAAA -> ACCTGCCAAAC
AACGACACGAC -> ACGACACGACA
AACGAGCTTAA -> ACGAGCTTAAA
AACGCATCTCG -> ACGCATCTCGG
AACGCCGATTT -> ACGCCGATTTG
AACGGAAAGGC -> ACGGAAAGGCA
AACGTGCGGAA -> ACGTGCGGAAT
AACGTGTTCGG -> ACGTGTTCGGG
AACGTTAATCC -> ACGTTAATCCA
AACGTTATCAA -> ACGTTATCAAC
AACTACGTCCT -> ACTACGTCCTT
AACTCGTGATT -> ACTCGTGATTG
AACTGAGTCCG -> ACTGAGTCCGG
AACTTCGGTAA -> ACTTCGGTAAG
AAGACGGAGCG -> AGACGGAGCGA
AAGACGTGGCA -> AGACGTGGCAC
AAGAGTTGTAT -> AGAGTTGTATC
AAGATTAGCAT -> AGATTAGCATT
AAGCAACGTGC -> AGCAACGTGCG
AAGCAGAACAG -> AGCAGAACAGG
AAGCATATCCG -> AGCATATCCGC
AAGCCAATACC -> AGCCAATACCT
AAGCCGGCGAC -> AGCCGGCGACT
AAGCGCCCAAG -> AGCGCCCAAGC
AAGCTCAGGGA -> AGCTCAGGGAA
AAGGATACAAA -> AGGATACAAAC
AAGGCAGCAAC -> AGGCAGCAACC
AAGGCGACCAG -> AGGCGACCAGA
AAGGCGCAAGG -> AGGCGCAAGGG
AAGGCGGTTAG -> AGGCGGTTAGG
AAGGGGACACC -> AGGGGACACCA
AAGGGGTCTGA -> AGGGGTCTGAC
AAGGTGCAACT -> AGGTGCAACTA
AAGTAGGCGGG -> AGTAGGCGGGT
AAGTATAGTAT -> AGTATAGTATC
AAGTGACTGAC -> AGTGACTGACC
AAGTGTTCCGG -> AGTGTTCCGGT
AAGTTCTAGGG -> AGTTCTAGGGG
AAGTTTAGTGA -> AGTTTAGTGAG
AAGTTTTCGAC -> AGTTTTCGACT
AATAACATGGA -> ATAACATGGAG
AATAATAGCGT -> ATAATAGCGTA
AATACCTATAA -> ATACCTATAAT
AATACTCCCAG -> ATACTCCCAGT
AATACTCTTCG -> ATACTCTTCGA
AATAGACGACG -> ATAGACGACGC
AATAGACGCCG -> ATAGACGCCGC
AATAGCCCTTT -> ATAGCCCTTTT
AATAGCGTAGA -> ATAGCGTAGAA
AATAGGCCAGA -> ATAGGCCAGAT
AATAGGGTAGA -> ATAGGGTAGAC
AATAGTTGAAC -> ATAGTTGAACG
AATAGTTGCTG -> ATAGTTGCTGT
AATATATGACT -> ATATATGACTT
AATATGCGGGC -> ATATGCGGGCT
AATATTGTGCG -> ATATTGTGCGA
AATCCAGCACG -> ATCCAGCACGT
AATCCCCGCAG -> ATCCCCGCAGA
AATCCCTATAC -> ATCCCTATACA
AATCCCTGGTT -> ATCCCTGGTTA
AATCGATTGCC -> ATCGATTGCCC
AATCGCGGTCT -> ATCGCGGTCTG
AATCGGATTTG -> ATCGGATTTGC
AATCGTCAAGA -> ATCGTCAAGAT
AATCGTGTTGC -> ATCGTGTTGCC
AATCTCTGCTT -> ATCTCTGCTTT
AATGACTTCGA -> ATGACTTCGAT
AATGCAGACCT -> ATGCAGACCTT
AATGCCTGCCT -> ATGCCTGCCTT
AATGGCTATGC -> ATGGCTATGCT
AATGGGAAATC -> ATGGGAAATCT
AATGGGCGAAA -> ATGGGCGAAAT
AATGGTCGCTC -> ATGGTCGCTCG
AATGTTATTAG -> ATGTTATTAGG
AATTAACGTGT -> ATTAACGTGTT
AATTATCATAT -> ATTATCATATC
AATTGCCTGAC -> ATTGCCTGACC
AATTGGTGATA -> ATTGGTGATAT
ACAAACGGAAA -> CAAACGGAAAG
ACAAAGCTCAG -> CAAAGCTCAGG
ACAACAGGGCA -> CAACAGGGCAC
ACAAGCAGAAC -> CAAGCAGAACA
ACACATGGATA -> CACATGGATAA
ACACCAAATAC -> CACCAAATACT
ACACCATGGCC -> CACCATGGCCA
ACACCTGACAA -> CACCTGACAAA
ACACGACATAT -> CACGACATATC
ACACGACGCCA -> CACGACGCCAT
ACAGAGCGTCT -> CAGAGCGTCTA
ACAGGGACGGC -> CAGGGACGGCG
ACAGGGCACAC -> CAGGGCACACG
ACAGGTCATGC -> CAGGTCATGCT
ACAGTTCCAGC -> CAGTTCCAGCG
ACAGTTCTCCT -> CAGTTCTCCTC
ACATATAATAT -> CATATAATATT
ACATATCGCCA -> CATATCGCCAT
ACATGCTTCGG -> CATGCTTCGGC
ACATGGAAGTT -> CATGGAAGTTC
ACATGGAGCAT -> CATGGAGCATA
ACATGGATAAG -> CATGGATAAGA
ACATTAGTGAA -> CATTAGTGAAT
ACCAAATACTC -> CCAAATACTCC
ACCAAATAGTT -> CCAAATAGTTG
ACCAGAGATCC -> CCAGAGATCCG
ACCAGCCAGGA -> CCAGCCAGGAA
ACCAGGATATG -> CCAGGATATGC
ACCATCTTGGG -> CCATCTTGGGT
ACCATGGCCAC -> CCATGGCCACA
ACCCAGCAAAG -> CCCAGCAAAGT
ACCCATAGATC -> CCCATAGATCT
ACCCCAGCTGA -> CCCCAGCTGAG
ACCCCGAACCC -> CCCCGAACCCC
ACCCCGATTTG -> CCCCGATTTGA
ACCCCGGTTCG -> CCCCGGTTCGT
ACCCCTGGACG -> CCCCTGGACGG
ACCCTTCACGG -> CCCTTCACGGG
ACCGACTTCGC -> CCGACTTCGCA
ACCGCATAAGC -> CCGCATAAGCC
ACCGCGGAAGG -> CCGCGGAAGGC
ACCGTGCGGGA -> CCGTGCGGGAT
ACCGTTTCGCT -> CCGTTTCGCTG
ACCTAATGCAG -> CCTAATGCAGA
ACCTACACCTG -> CCTACACCTGA
ACCTAGAATGG -> CCTAGAATGGG
ACCTATAATAG -> CCTATAATAGG
ACCTCCGCGAG -> CCTCCGCGAGA
ACCTCGTGATG -> CCTCGTGATGC
ACCTGACAAAG -> CCTGACAAAGC
ACCTGCCAAAC -> CCTGCCAAACC
ACCTTCGTCCT -> CCTTCGTCCTT
ACCTTTTTATT -> CCTTTTTATTC
ACGACACGACA -> CGACACGACAT
ACGACATATCG -> CGACATATCGC
ACGACGCCATA -> CGACGCCATAC,CGACGCCATAG
ACGACGGGATT -> CGACGGGATTC
ACGACGGGTAA -> CGACGGGTAAT
ACGAGAGTGAG -> CGAGAGTGAGC
ACGAGCTTAAA -> CGAGCTTAAAA
ACGCATCTCGG -> CGCATCTCGGT
ACGCCATACCT -> CGCCATACCTA
ACGCCATAGTT -> CGCCATAGTTA
ACGCCGATTTG -> CGCCGATTTGT
ACGCCGCTGTC -> CGCCGCTGTCT
ACGGAAAGGCA -> CGGAAAGGCAG
ACGGAGCGATG -> CGGAGCGATGA
ACGGCGGATGG -> CGGCGGATGGG
ACGGGATTCTC -> CGGGATTCTCT
ACGGGCTGTTG -> CGGGCTGTTGT
ACGGGTAATCC -> CGGGTAATCCC
ACGGTGGTAGC -> CGGTGGTAGCA
ACGTAATATGC -> CGTAATATGCG
ACGTCCTTCTA -> CGTCCTTCTAC
ACGTGATGCAA -> CGTGATGCAAA
ACGTGCGGAAT -> CGTGCGGAATA
ACGTGGCACCG -> CGTGGCACCGT
ACGTGTTCGGG -> CGTGTTCGGGG
ACGTTAATCCA -> CGTTAATCCAG
ACGTTATCAAC -> CGTTATCAACA
ACGTTCTTACT -> CGTTCTTACTC
ACTAAACGAGC -> CTAAACGAGCT
ACTAAGTGACT -> CTAAGTGACTG
ACTAATAGTTG -> CTAATAGTTGC
ACTACGTCCTT -> CTACGTCCTTC
ACTACTGGGTT -> CTACTGGGTTC
ACTAGGAGGAC -> CTAGGAGGACT
ACTATTGGAGG -> CTATTGGAGGT
ACTCAACGTTA -> CTCAACGTTAT
ACTCAGTAGGA -> CTCAGTAGGAG
ACTCCCAGTGT -> CTCCCAGTGTG
ACTCCCATTCC -> CTCCCATTCCT
ACTCCCGCTAT -> CTCCCGCTATT
ACTCCCTTGAG -> CTCCCTTGAGC
ACTCGATTATA -> CTCGATTATAC
ACTCGGGCTCA -> CTCGGGCTCAG
ACTCGTGATTG -> CTCGTGATTGG
ACTCTTCGAAT -> CTCTTCGAATT
ACTGACCCCGG -> CTGACCCCGGT
ACTGAGTCCGG -> CTGAGTCCGGC
ACTGCATGGTC -> CTGCATGGTCC
ACTGGGTTCAT -> CTGGGTTCATT
ACTGTTTGCAA -> CTGTTTGCAAG
ACTTAACTCGT -> CTTAACTCGTG
ACTTAGTTGCT -> CTTAGTTGCTA
ACTTCAGTATA -> CTTCAGTATAT
ACTTCCCACTC -> CTTCCCACTCC
ACTTCGATAGT -> CTTCGATAGTC
ACTTCGCATTC -> CTTCGCATTCT
ACTTCGGTAAG -> CTTCGGTAAGT
ACTTCTACAAG -> CTTCTACAAGC
ACTTGTGCCGG -> CTTGTGCCGGT
AGAAAATCGGA -> GAAAATCGGAT
AGAAATGGTCG -> GAAATGGTCGC
AGAACAGGTCA -> GAACAGGTCAT
AGAACCTAATG -> GAACCTAATGC
AGAACGCATCT -> GAACGCATCTC
AGAATAGACGA -> GAATAGACGAC
AGAATGGGCGA -> GAATGGGCGAA
AGAATGTTATT -> GAATGTTATTA
AGAATTATCAT -> GAATTATCATA
AGACAGTTCCA -> GACAGTTCCAG
AGACCCATAGA -> GACCCATAGAT
AGACCGACTTC -> GACCGACTTCG
AGACCTTCGTC -> GACCTTCGTCC
AGACGACGCCA -> GACGACGCCAT
AGACGCCGCTG -> GACGCCGCTGT
AGACGGAGCGA -> GACGGAGCGAT
AGACGTGGCAC -> GACGTGGCACC
AGAGATCCGAT -> GAGATCCGATC
AGAGCGGAAAC -> GAGCGGAAACT
AGAGCGTCTAC -> GAGCGTCTACC
AGAGTCGTATC -> GAGTCGTATCA
AGAGTGAGCCT -> GAGTGAGCCTA
AGAGTTAGTTT -> GAGTTAGTTTA
AGAGTTGTATC -> GAGTTGTATCG
AGATAGCGTCG -> GATAGCGTCGT
AGATATGGAAA -> GATATGGAAAG
AGATCCGATCC -> GATCCGATCCG
AGATCTCGCCA -> GATCTCGCCAA
AGATTAGCATT -> GATTAGCATTT
AGATTGGGAAC -> GATTGGGAACC
AGCAAAGTTTT -> GCAAAGTTTTC
AGCAACCGTGC -> GCAACCGTGCG
AGCAACGTGCG -> GCAACGTGCGG
AGCAAGCATAT -> GCAAGCATATC
AGCACGTTCTT -> GCACGTTCTTA
AGCACTTAGTT -> GCACTTAGTTG
AGCAGAACAGG -> GCAGAACAGGT
AGCATAGGAAT -> GCATAGGAATC
AGCATATCCGC -> GCATATCCGCT
AGCATTTACTA -> GCATTTACTAG
AGCCAAACACC -> GCCAAACACCA
AGCCAATACCT -> GCCAATACCTA
AGCCAGGAAGG -> GCCAGGAAGGA
AGCCCAAGGTG -> GCCCAAGGTGC
AGCCCTTTTCA -> GCCCTTTTCAA
AGCCGGCGACT -> GCCGGCGACTA
AGCCTAAAACG -> GCCTAAAACGC
AGCGATGAGTT -> GCGATGAGTTC
AGCGCCCAAGC -> GCGCCCAAGCA
AGCGGAAACTG -> GCGGAAACTGA
AGCGTAGAACG -> GCGTAGAACGC
AGCGTCGTCTC -> GCGTCGTCTCT
AGCGTCTACCT -> GCGTCTACCTT
AGCTACGTGAT -> GCTACGTGATG
AGCTATTGGGG -> GCTATTGGGGT
AGCTCAGGGAA -> GCTCAGGGAAT
AGCTCGATGAA -> GCTCGATGAAC
AGCTGAGGAAT -> GCTGAGGAATA
AGCTTAAAAGC -> GCTTAAAAGCG
AGGAAGGATAC -> GGAAGGATACA
AGGAATAGCCC -> GGAATAGCCCT
AGGAATCGTGT -> GGAATCGTGTT
AGGACTAATAG -> GGACTAATAGT
AGGAGAATGTT -> GGAGAATGTTA
AGGAGAGCGGA -> GGAGAGCGGAA
AGGAGGACTAA -> GGAGGACTAAT
AGGATACAAAC -> GGATACAAACG
AGGATATGCAT -> GGATATGCATT
AGGCAATTGCC -> GGCAATTGCCT
AGGCAGCAACC -> GGCAGCAACCG
AGGCCAGATAT -> GGCCAGATATG
AGGCCGTAAGG -> GGCCGTAAGGC
AGGCGACCAGA -> GGCGACCAGAG
AGGCGCAAGGG -> GGCGCAAGGGG
AGGCGGGAATC -> GGCGGGAATCG
AGGCGGGTGGA -> GGCGGGTGGAA
AGGCGGTTAGG -> GGCGGTTAGGT
AGGGAATAGGG -> GGGAATAGGGT
AGGGACGGCGG -> GGGACGGCGGA
AGGGCACACAT -> GGGCACACATG
AGGGCACACGA -> GGGCACACGAC
AGGGCGATGCA -> GGGCGATGCAG
AGGGGACACCA -> GGGGACACCAA
AGGGGATAAGG -> GGGGATAAGGG
AGGGGGGTGTA -> GGGGGGTGTAT
AGGGGTCTGAC -> GGGGTCTGACT
AGGGTAGACAG -> GGGTAGACAGT
AGGGTGGGTGC -> GGGTGGGTGCG
AGGTACCGCGG -> GGTACCGCGGA
AGGTACTCAGT -> GGTACTCAGTA
AGGTATGATTT -> GGTATGATTTG
AGGTCATGCTA -> GGTCATGCTAT
AGGTCCGGCCC -> GGTCCGGCCCT
AGGTCCTATTG -> GGTCCTATTGC
AGGTGCAACTA -> GGTGCAACTAC
AGGTTTTCTGA -> GGTTTTCTGAG
AGTACATGCTT -> GTACATGCTTC
AGTACGACGGG -> GTACGACGGGA
AGTAGCTACGT -> GTAGCTACGTG
AGTAGGAGAGC -> GTAGGAGAGCG
AGTAGGCGGGT -> GTAGGCGGGTG
AGTATAGTATC -> GTATAGTATCG
AGTATATCCGT -> GTATATCCGTG
AGTATCGGTTA -> GTATCGGTTAC
AGTCACCTCGT -> GTCACCTCGTG
AGTCCGGCTGG -> GTCCGGCTGGG
AGTCGTATCAG -> GTCGTATCAGG
AGTCGTCCGGT -> GTCGTCCGGTT
AGTGAATGACT -> GTGAATGACTT
AGTGACTGACC -> GTGACTGACCC
AGTGAGCCTAA -> GTGAGCCTAAA
AGTGAGGCGGG -> GTGAGGCGGGA
AGTGTGTTCAC -> GTGTGTTCACT
AGTGTTCCGGT -> GTGTTCCGGTT
AGTTAGAGTCG -> GTTAGAGTCGT
AGTTAGTTTAC -> GTTAGTTTACC
AGTTCAATTAA -> GTTCAATTAAC
AGTTCCAGCGA -> GTTCCAGCGAC
AGTTCTAGGGG -> GTTCTAGGGGG
AGTTCTCCTCG -> GTTCTCCTCGA
AGTTGAACGAC -> GTTGAACGACA
AGTTGCTATCG -> GTTGCTATCGT
AGTTGCTGTGT -> GTTGCTGTGTT
AGTTGTATCGT -> GTTGTATCGTT
AGTTTACCAAA -> GTTTACCAAAT
AGTTTAGTGAG -> GTTTAGTGAGG
AGTTTTCGACT -> GTTTTCGACTT
ATAACATGGAG -> TAACATGGAGC
ATAAGACGTGG -> TAAGACGTGGC
ATAAGCCGGCG -> TAAGCCGGCGA
ATAAGGGGTCT -> TAAGGGGTCTG
ATAATAGCGTA -> TAATAGCGTAG
ATAATAGGCCA -> TAATAGGCCAG
ATAATATTGTG -> TAATATTGTGC
ATACAAACGGA -> TACAAACGGAA
ATACAGAGCGT -> TACAGAGCGTC
ATACCAGGATA -> TACCAGGATAT
ATACCTAGAAT -> TACCTAGAATG
ATACCTATAAT -> TACCTATAATA
ATACTCCCAGT -> TACTCCCAGTG
ATACTCGGGCT -> TACTCGGGCTC
ATACTCTTCGA -> TACTCTTCGAA
ATAGACGACGC -> TAGACGACGCC
ATAGACGCCGC -> TAGACGCCGCT
ATAGATCTCGC -> TAGATCTCGCC
ATAGCCCTTTT -> TAGCCCTTTTC
ATAGCGTAGAA -> TAGCGTAGAAC
ATAGCGTCGTC -> TAGCGTCGTCT
ATAGGAATCGT -> TAGGAATCGTG
ATAGGCCAGAT -> TAGGCCAGATA
ATAGGGTAGAC -> TAGGGTAGACA
ATAGTATCGGT -> TAGTATCGGTT
ATAGTCGTCCG -> TAGTCGTCCGG
ATAGTTAGAGT -> TAGTTAGAGTC
ATAGTTGAACG -> TAGTTGAACGA
ATAGTTGCTGT -> TAGTTGCTGTG
ATATAATATTG -> TATAATATTGT
ATATATGACTT -> TATATGACTTC
ATATCCGCTAG -> TATCCGCTAGT
ATATCCGCTCT -> TATCCGCTCTC
ATATCCGTGTG -> TATCCGTGTGA
ATATCGCCATT -> TATCGCCATTG
ATATGACTTCA -> TATGACTTCAG
ATATGCATTTA -> TATGCATTTAA
ATATGCGGGCT -> TATGCGGGCTG
ATATGGAAAGA -> TATGGAAAGAC
ATATTCTTTCG -> TATTCTTTCGA
ATATTGTGCGA -> TATTGTGCGAT
ATCAACAACAG -> TCAACAACAGG
ATCAGCCAAAC -> TCAGCCAAACA
ATCAGGTCCTA -> TCAGGTCCTAT
ATCATATCCGC -> TCATATCCGCT
ATCCAGCACGT -> TCCAGCACGTT
ATCCATTACCT -> TCCATTACCTC
ATCCCCGCAGA -> TCCCCGCAGAT
ATCCCTATACA -> TCCCTATACAG
ATCCCTGGTTA -> TCCCTGGTTAG
ATCCGATCCGT -> TCCGATCCGTC
ATCCGCTAGTA -> TCCGCTAGTAG
ATCCGCTCTCT -> TCCGCTCTCTA
ATCCGTCAGGC -> TCCGTCAGGCC
ATCCGTGTGAG -> TCCGTGTGAGA
ATCGATGCAGC -> TCGATGCAGCT
ATCGATTGCCC -> TCGATTGCCCC
ATCGCCATTGT -> TCGCCATTGTC
ATCGCGACCTA -> TCGCGACCTAC
ATCGCGGTCTG -> TCGCGGTCTGA
ATCGGATTTGC -> TCGGATTTGCG
ATCGGTTACTC -> TCGGTTACTCA
ATCGTAACGTT -> TCGTAACGTTA
ATCGTCAAGAT -> TCGTCAAGATT
ATCGTGTTGCC -> TCGTGTTGCCA
ATCGTTTCTTT -> TCGTTTCTTTC
ATCTAAATGCC -> TCTAAATGCCT
ATCTCGCCAAT -> TCTCGCCAATA
ATCTCGGTGCC -> TCTCGGTGCCG
ATCTCTGCTTT -> TCTCTGCTTTC
ATCTGTCGCAC -> TCTGTCGCACT
ATCTTGGGTTA -> TCTTGGGTTAC
ATGAAAGTGTT -> TGAAAGTGTTC
ATGAACTTCGG -> TGAACTTCGGT
ATGACTTCAGT -> TGACTTCAGTA
ATGACTTCGAT -> TGACTTCGATA
ATGAGTTCAAT -> TGAGTTCAATT
ATGATTTGTAA -> TGATTTGTAAT
ATGCAAACCCA -> TGCAAACCCAG
ATGCAGACCTT -> TGCAGACCTTC
ATGCAGCACTT -> TGCAGCACTTA
ATGCAGCTATT -> TGCAGCTATTG
ATGCATTTAAG -> TGCATTTAAGT
ATGCCTGCCTT -> TGCCTGCCTTG
ATGCGGACATA -> TGCGGACATAT
ATGCGGGCTGC -> TGCGGGCTGCA
ATGCTATCTAA -> TGCTATCTAAA
ATGCTCGGGAT -> TGCTCGGGATC
ATGCTTCGGCT -> TGCTTCGGCTA
ATGGAAAGACG -> TGGAAAGACGG
ATGGAAGTTCT -> TGGAAGTTCTA
ATGGAGCATAG -> TGGAGCATAGG
ATGGATAAGAC -> TGGATAAGACG
ATGGCCACATT -> TGGCCACATTA
ATGGCTATGCT -> TGGCTATGCTC
ATGGGAAATCT -> TGGGAAATCTC
ATGGGCGAAAT -> TGGGCGAAATC
ATGGGCTCACC -> TGGGCTCACCC
ATGGTCCTATG -> TGGTCCTATGT
ATGGTCGCTCG -> TGGTCGCTCGA
ATGTTATTAGG -> TGTTATTAGGG
ATGTTCAGGGT -> TGTTCAGGGTG
ATTAACAGGGA -> TTAACAGGGAC
ATTAACGTGTT -> TTAACGTGTTC
ATTACCTCCGC -> TTACCTCCGCG
ATTAGAAATGG -> TTAGAAATGGT
ATTAGCATTTA -> TTAGCATTTAC
ATTAGGGCACA -> TTAGGGCACAC
ATTAGGGGATA -> TTAGGGGATAA
ATTAGTGAATG -> TTAGTGAATGA
ATTATACCAGG -> TTATACCAGGA
ATTATACTCGG -> TTATACTCGGG
ATTATCATATC -> TTATCATATCC
ATTATCGCGAC -> TTATCGCGACC
ATTCAGACCGA -> TTCAGACCGAC
ATTCATCAGCC -> TTCATCAGCCA
ATTCCTAGGTA -> TTCCTAGGTAC
ATTCTCTTACT -> TTCTCTTACTA
ATTCTGAGAAT -> TTCTGAGAATA
ATTCTTTCCAA -> TTCTTTCCAAA
ATTCTTTCGAC -> TTCTTTCGACA
ATTGCCAGGGC -> TTGCCAGGGCG
ATTGCCCCTAG -> TTGCCCCTAGG
ATTGCCTGACC -> TTGCCTGACCG
ATTGGAGAACC -> TTGGAGAACCT
ATTGGAGGTAC -> TTGGAGGTACT
ATTGGGAACCT -> TTGGGAACCTG
ATTGGGGTCCC -> TTGGGGTCCCC
ATTGGTCACGT -> TTGGTCACGTA
ATTGGTGATAT -> TTGGTGATATT
ATTGTCACTAA -> TTGTCACTAAA
ATTGTGCGATT -> TTGTGCGATTA
ATTTAAGTTTA -> TTTAAGTTTAG
ATTTACTAGGA -> TTTACTAGGAG
ATTTGACGAGA -> TTTGACGAGAG
ATTTGCGTCGC -> TTTGCGTCGCG
ATTTGTAATAA -> TTTGTAATAAT
ATTTGTTTAAT -> TTTGTTTAATG
CAAACACCATG -> AAACACCATGG
CAAACAGTTCT -> AAACAGTTCTC
CAAACCCAGCA -> AAACCCAGCAA
CAAACCCCGAA -> AAACCCCGAAC
CAAACGGAAAG -> AAACGGAAAGG
CAAAGCTCAGG -> AAAGCTCAGGG
CAAAGGCGCAA -> AAAGGCGCAAG
CAAAGTAGGCG -> AAAGTAGGCGG
CAAAGTTTTCG -> AAAGTTTTCGA
CAAATACTCCC -> AAATACTCCCA
CAAATAGTTGA -> AAATAGTTGAA
CAAATCGTCAA -> AAATCGTCAAG
CAACAACAGGG -> AACAACAGGGC
CAACAGGGCAC -> AACAGGGCACA
CAACCGTGCGG -> AACCGTGCGGG
CAACGTGCGGA -> AACGTGCGGAA
CAACGTTATCA -> AACGTTATCAA
CAACTACGTCC -> AACTACGTCCT
CAAGAGTTGTA -> AAGAGTTGTAT
CAAGATTAGCA -> AAGATTAGCAT
CAAGCAACGTG -> AAGCAACGTGC
CAAGCAGAACA -> AAGCAGAACAG
CAAGCATATCC -> AAGCATATCCG
CAAGGGGACAC -> AAGGGGACACC
CAAGGTGCAAC -> AAGGTGCAACT
CAATACCTATA -> AATACCTATAA
CAATAGACGCC -> AATAGACGCCG
CAATTAACGTG -> AATTAACGTGT
CAATTGCCTGA -> AATTGCCTGAC
CACACATGGAT -> ACACATGGATA
CACACGACGCC -> ACACGACGCCA
CACATGGATAA -> ACATGGATAAG
CACATTAGTGA -> ACATTAGTGAA
CACCAAATACT -> ACCAAATACTC
CACCATGGCCA -> ACCATGGCCAC
CACCCTTCACG -> ACCCTTCACGG
CACCGTTTCGC -> ACCGTTTCGCT
CACCTCGTGAT -> ACCTCGTGATG
CACCTGACAAA -> ACCTGACAAAG
CACGACATATC -> ACGACATATCG
CACGACGCCAT -> ACGACGCCATA
CACGGGCTGTT -> ACGGGCTGTTG
CACGTAATATG -> ACGTAATATGC
CACGTTCTTAC -> ACGTTCTTACT
CACTAAACGAG -> ACTAAACGAGC
CACTACTGGGT -> ACTACTGGGTT
CACTCCCATTC -> ACTCCCATTCC
CACTCCCGCTA -> ACTCCCGCTAT
CACTTAGTTGC -> ACTTAGTTGCT
CACTTGTGCCG -> ACTTGTGCCGG
CAGAACAGGTC -> AGAACAGGTCA
CAGACCCATAG -> AGACCCATAGA
CAGACCGACTT -> AGACCGACTTC
CAGACCTTCGT -> AGACCTTCGTC
CAGAGATCCGA -> AGAGATCCGAT
CAGAGCGTCTA -> AGAGCGTCTAC
CAGAGTTAGTT -> AGAGTTAGTTT
CAGATAGCGTC -> AGATAGCGTCG
CAGATATGGAA -> AGATATGGAAA
CAGCAAAGTTT -> AGCAAAGTTTT
CAGCAACCGTG -> AGCAACCGTGC
CAGCACGTTCT -> AGCACGTTCTT
CAGCACTTAGT -> AGCACTTAGTT
CAGCCAAACAC -> AGCCAAACACC
CAGCCAGGAAG -> AGCCAGGAAGG
CAGCTATTGGG -> AGCTATTGGGG
CAGCTGAGGAA -> AGCTGAGGAAT
CAGGAAGGATA -> AGGAAGGATAC
CAGGATATGCA -> AGGATATGCAT
CAGGCCGTAAG -> AGGCCGTAAGG
CAGGGAATAGG -> AGGGAATAGGG
CAGGGACGGCG -> AGGGACGGCGG
CAGGGCACACG -> AGGGCACACGA
CAGGGCGATGC -> AGGGCGATGCA
CAGGGTGGGTG -> AGGGTGGGTGC
CAGGTCATGCT -> AGGTCATGCTA
CAGGTCCTATT -> AGGTCCTATTG
CAGTAGGAGAG -> AGTAGGAGAGC
CAGTATATCCG -> AGTATATCCGT
CAGTCACCTCG -> AGTCACCTCGT
CAGTGTGTTCA -> AGTGTGTTCAC
CAGTTCCAGCG -> AGTTCCAGCGA
CAGTTCTCCTC -> AGTTCTCCTCG
CATAAGCCGGC -> ATAAGCCGGCG
CATACCTAGAA -> ATACCTAGAAT
CATAGATCTCG -> ATAGATCTCGC
CATAGGAATCG -> ATAGGAATCGT
CATAGTTAGAG -> ATAGTTAGAGT
CATATAATATT -> ATATAATATTG
CATATCCGCTA -> ATATCCGCTAG
CATATCCGCTC -> ATATCCGCTCT
CATATCGCCAT -> ATATCGCCATT
CATCAGCCAAA -> ATCAGCCAAAC
CATCTCGGTGC -> ATCTCGGTGCC
CATCTTGGGTT -> ATCTTGGGTTA
CATGCTATCTA -> ATGCTATCTAA
CATGCTTCGGC -> ATGCTTCGGCT
CATGGAAGTTC -> ATGGAAGTTCT
CATGGAGCATA -> ATGGAGCATAG
CATGGATAAGA -> ATGGATAAGAC
CATGGCCACAT -> ATGGCCACATT
CATGGTCCTAT -> ATGGTCCTATG
CATTACCTCCG -> ATTACCTCCGC
CATTAGGGCAC -> ATTAGGGCACA
CATTAGTGAAT -> ATTAGTGAATG
CATTATCGCGA -> ATTATCGCGAC
CATTCCTAGGT -> ATTCCTAGGTA
CATTCTTTCCA -> ATTCTTTCCAA
CATTGGTCACG -> ATTGGTCACGT
CATTGTCACTA -> ATTGTCACTAA
CATTTAAGTTT -> ATTTAAGTTTA
CATTTACTAGG -> ATTTACTAGGA
CCAAACACCAT -> CAAACACCATG
CCAAACCCCGA -> CAAACCCCGAA
CCAAAGGCGCA -> CAAAGGCGCAA
CCAAATACTCC -> CAAATACTCCC
CCAAATAGTTG -> CAAATAGTTGA
CCAAGCAACGT -> CAAGCAACGTG
CCAAGGTGCAA -> CAAGGTGCAAC
CCAATACCTAT -> CAATACCTATA
CCAATAGACGC -> CAATAGACGCC
CCACATTAGTG -> CACATTAGTGA
CCACTCCCGCT -> CACTCCCGCTA
CCAGAGATCCG -> CAGAGATCCGA
CCAGATATGGA -> CAGATATGGAA
CCAGCAAAGTT -> CAGCAAAGTTT
CCAGCACGTTC -> CAGCACGTTCT
CCAGCCAGGAA -> CAGCCAGGAAG
CCAGCTGAGGA -> CAGCTGAGGAA
CCAGGAAGGAT -> CAGGAAGGATA
CCAGGATATGC -> CAGGATATGCA
CCAGGGCGATG -> CAGGGCGATGC
CCAGTCACCTC -> CAGTCACCTCG
CCAGTGTGTTC -> CAGTGTGTTCA
CCATACCTAGA -> CATACCTAGAA
CCATAGATCTC -> CATAGATCTCG
CCATAGTTAGA -> CATAGTTAGAG
CCATCTTGGGT -> CATCTTGGGTT
CCATGGCCACA -> CATGGCCACAT
CCATTACCTCC -> CATTACCTCCG
CCATTATCGCG -> CATTATCGCGA
CCATTCCTAGG -> CATTCCTAGGT
CCATTGTCACT -> CATTGTCACTA
CCCAAGCAACG -> CCAAGCAACGT
CCCAAGGTGCA -> CCAAGGTGCAA
CCCACTCCCGC -> CCACTCCCGCT
CCCAGCAAAGT -> CCAGCAAAGTT
CCCAGCTGAGG -> CCAGCTGAGGA
CCCAGTGTGTT -> CCAGTGTGTTC
CCCATAGATCT -> CCATAGATCTC
CCCATTCCTAG -> CCATTCCTAGG
CCCCAGCTGAG -> CCCAGCTGAGG
CCCCGAACCCC -> CCCGAACCCCT
CCCCGATTTGA -> CCCGATTTGAC
CCCCGCAGATA -> CCCGCAGATAG
CCCCGGTTCGT -> CCCGGTTCGTG
CCCCGTGAAAT -> CCCGTGAAATA
CCCCTAGGTTT -> CCCTAGGTTTT
CCCCTGGACGG -> CCCTGGACGGT
CCCCTGTGACC -> CCCTGTGACCC
CCCGAACCCCT -> CCGAACCCCTG
CCCGATTTGAC -> CCGATTTGACG
CCCGCAGATAG -> CCGCAGATAGC
CCCGCTATTAA -> CCGCTATTAAC
CCCGGTTCGTG -> CCGGTTCGTGA
CCCGTGAAATA -> CCGTGAAATAT
CCCTAGGTTTT -> CCTAGGTTTTC
CCCTATACAGA -> CCTATACAGAG
CCCTGGACGGT -> CCTGGACGGTG
CCCTGGTTAGC -> CCTGGTTAGCT
CCCTGTGACCC -> CCTGTGACCCC
CCCTTCACGGG -> CCTTCACGGGC
CCCTTGAATCC -> CCTTGAATCCC
CCCTTGAGCCC -> CCTTGAGCCCA
CCCTTTTCAAA -> CCTTTTCAAAG
CCGAACCCCTG -> CGAACCCCTGG
CCGACCATCTT -> CGACCATCTTG
CCGACTTCGCA -> CGACTTCGCAT
CCGATCCGTCA -> CGATCCGTCAG
CCGATTTGACG -> CGATTTGACGA
CCGATTTGTTT -> CGATTTGTTTA
CCGCAGATAGC -> CGCAGATAGCG
CCGCATAAGCC -> CGCATAAGCCG
CCGCGAGATTG -> CGCGAGATTGG
CCGCGGAAGGC -> CGCGGAAGGCG
CCGCTAGTAGC -> CGCTAGTAGCT
CCGCTATTAAC -> CGCTATTAACA
CCGCTCTCTAG -> CGCTCTCTAGG
CCGCTGTCTTG -> CGCTGTCTTGT
CCGCTTTGCGG -> CGCTTTGCGGG
CCGGCCCTTGA -> CGGCCCTTGAA
CCGGCGACTAT -> CGGCGACTATT
CCGGCTGGGTA -> CGGCTGGGTAC
CCGGTGACCAG -> CGGTGACCAGC
CCGGTTAATAC -> CGGTTAATACT
CCGGTTCGTGA -> CGGTTCGTGAT
CCGGTTCTGTG -> CGGTTCTGTGT
CCGTAAGGCGG -> CGTAAGGCGGT
CCGTCAGGCCG -> CGTCAGGCCGT
CCGTGAAATAT -> CGTGAAATATA
CCGTGCGGGAT -> CGTGCGGGATC
CCGTGTGAGAA -> CGTGTGAGAAT
CCGTTTCGCTG -> CGTTTCGCTGA
CCTAAAACGCC -> CTAAAACGCCG
CCTAATGCAGA -> CTAATGCAGAC
CCTACACCTGA -> CTACACCTGAC
CCTAGAATGGG -> CTAGAATGGGC
CCTAGGTACCG -> CTAGGTACCGC
CCTAGGTTTTC -> CTAGGTTTTCT
CCTATAATAGG -> CTATAATAGGC
CCTATACAGAG -> CTATACAGAGC
CCTATGTTCAG -> CTATGTTCAGG
CCTATTGCCAG -> CTATTGCCAGG
CCTCCGCGAGA -> CTCCGCGAGAT
CCTCGAGTACG -> CTCGAGTACGA
CCTCGTGATGC -> CTCGTGATGCG
CCTGACAAAGC -> CTGACAAAGCT
CCTGACCGCAT -> CTGACCGCATA
CCTGCCAAACC -> CTGCCAAACCC
CCTGCCTTGCC -> CTGCCTTGCCC
CCTGGACGGTG -> CTGGACGGTGG
CCTGGTTAGCT -> CTGGTTAGCTC
CCTGTGACCCC -> CTGTGACCCCG
CCTTACTGTTT -> CTTACTGTTTG
CCTTCACGGGC -> CTTCACGGGCT
CCTTCATTAGG -> CTTCATTAGGG
CCTTCGTCCTT -> CTTCGTCCTTA
CCTTCTACTTC -> CTTCTACTTCT
CCTTGAATCCC -> CTTGAATCCCT
CCTTGAGCCCA -> CTTGAGCCCAA
CCTTGCCCCTG -> CTTGCCCCTGT
CCTTTTCAAAG -> CTTTTCAAAGT
CCTTTTTATTC -> CTTTTTATTCA
CGAAATCCCTG -> GAAATCCCTGG
CGAACCCCTGG -> GAACCCCTGGA
CGAATTGGTGA -> GAATTGGTGAT
CGACACGACAT -> GACACGACATA
CGACATATCGC -> GACATATCGCC
CGACATGGAAG -> GACATGGAAGT
CGACCAGAGAT -> GACCAGAGATC
CGACCATCTTG -> GACCATCTTGG
CGACCCCAGCT -> GACCCCAGCTG
CGACCTACACC -> GACCTACACCT
CGACGCCATAC -> GACGCCATACC
CGACGCCATAG -> GACGCCATAGT
CGACGGGATTC -> GACGGGATTCT
CGACGGGTAAT -> GACGGGTAATC
CGACTATTGGA -> GACTATTGGAG
CGACTTAACTC -> GACTTAACTCG
CGACTTCGCAT -> GACTTCGCATT
CGAGAGTGAGC -> GAGAGTGAGCC
CGAGATTGGGA -> GAGATTGGGAA
CGAGCTTAAAA -> GAGCTTAAAAG
CGAGTACGACG -> GAGTACGACGG
CGATAGTCGTC -> GATAGTCGTCC
CGATCCGTCAG -> GATCCGTCAGG
CGATGAACTTC -> GATGAACTTCG
CGATGAGTTCA -> GATGAGTTCAA
CGATGCAGCAC -> GATGCAGCACT
CGATGCAGCTA -> GATGCAGCTAT
CGATTATACCA -> GATTATACCAG
CGATTATACTC -> GATTATACTCG
CGATTGCCCCT -> GATTGCCCCTA
CGATTTGACGA -> GATTTGACGAG
CGATTTGTTTA -> GATTTGTTTAA
CGCAAGGGGAC -> GCAAGGGGACA
CGCACTACTGG -> GCACTACTGGG
CGCAGATAGCG -> GCAGATAGCGT
CGCATAAGCCG -> GCATAAGCCGG
CGCATCTCGGT -> GCATCTCGGTG
CGCATTCTTTC -> GCATTCTTTCC
CGCCAATAGAC -> GCCAATAGACG
CGCCATACCTA -> GCCATACCTAG
CGCCATAGTTA -> GCCATAGTTAG
CGCCATTGTCA -> GCCATTGTCAC
CGCCCAAGCAA -> GCCCAAGCAAC
CGCCGATTTGT -> GCCGATTTGTT
CGCCGCTGTCT -> GCCGCTGTCTT
CGCCTTCATTA -> GCCTTCATTAG
CGCGACCTACA -> GCGACCTACAC
CGCGAGATTGG -> GCGAGATTGGG
CGCGGAAGGCG -> GCGGAAGGCGA
CGCGGTCTGAG -> GCGGTCTGAGG
CGCGTTATTCA -> GCGTTATTCAT
CGCTAGTAGCT -> GCTAGTAGCTA
CGCTATTAACA -> GCTATTAACAG
CGCTCGACCCC -> GCTCGACCCCA
CGCTCTCTAGG -> GCTCTCTAGGA
CGCTGAGAAAA -> GCTGAGAAAAT
CGCTGTCTTGT -> GCTGTCTTGTG
CGCTTTGCGGG -> GCTTTGCGGGT
CGGAAACTGAG -> GGAAACTGAGT
CGGAAAGGCAG -> GGAAAGGCAGC
CGGAAGGCGAC -> GGAAGGCGACC
CGGAATAACAT -> GGAATAACATG
CGGACATATAA -> GGACATATAAT
CGGAGCGATGA -> GGAGCGATGAG
CGGATGGGCTC -> GGATGGGCTCA
CGGATTTGCGT -> GGATTTGCGTC
CGGCCCTTGAA -> GGCCCTTGAAT
CGGCGACTATT -> GGCGACTATTG
CGGCGGATGGG -> GGCGGATGGGC
CGGCTAATGGC -> GGCTAATGGCT
CGGCTGGGTAC -> GGCTGGGTACT
CGGGAATCGCG -> GGGAATCGCGG
CGGGATCGATG -> GGGATCGATGC
CGGGATCTGTC -> GGGATCTGTCG
CGGGATTCTCT -> GGGATTCTCTT
CGGGCTCAGAG -> GGGCTCAGAGT
CGGGCTGCAGA -> GGGCTGCAGAC
CGGGCTGTTGT -> GGGCTGTTGTG
CGGGGACTCCC -> GGGGACTCCCT
CGGGTAATCCC -> GGGTAATCCCC
CGGGTGCGCCT -> GGGTGCGCCTT
CGGGTGGAAGC -> GGGTGGAAGCC
CGGTAAGTATA -> GGTAAGTATAG
CGGTCTGAGGC -> GGTCTGAGGCA
CGGTGACCAGC -> GGTGACCAGCC
CGGTGCCGCTT -> GGTGCCGCTTT
CGGTGGTAGCA -> GGTGGTAGCAA
CGGTTAATACT -> GGTTAATACTC
CGGTTACTCAA -> GGTTACTCAAC
CGGTTAGGTCC -> GGTTAGGTCCG
CGGTTCGTGAT -> GGTTCGTGATT
CGGTTCTGTGT -> GGTTCTGTGTG
CGTAACGTTAA -> GTAACGTTAAT
CGTAAGGCGGT -> GTAAGGCGGTT
CGTAATATGCG -> GTAATATGCGG
CGTAGAACGCA -> GTAGAACGCAT
CGTATCAGGTC -> GTATCAGGTCC
CGTATTAGAAA -> GTATTAGAAAT
CGTCAAGATTA -> GTCAAGATTAG
CGTCAGGCCGT -> GTCAGGCCGTA
CGTCCGGTTCT -> GTCCGGTTCTG
CGTCCTTACTG -> GTCCTTACTGT
CGTCCTTCTAC -> GTCCTTCTACT
CGTCGCGTTAT -> GTCGCGTTATT
CGTCGTCTCTA -> GTCGTCTCTAT
CGTCTACCTTT -> GTCTACCTTTT
CGTCTCTATGA -> GTCTCTATGAA
CGTGAAATATA -> GTGAAATATAT
CGTGATGCAAA -> GTGATGCAAAC
CGTGATGCGGA -> GTGATGCGGAC
CGTGATTCTGA -> GTGATTCTGAG
CGTGATTGGAG -> GTGATTGGAGA
CGTGCGGAATA -> GTGCGGAATAA
CGTGCGGGATC -> GTGCGGGATCG
CGTGGCACCGT -> GTGGCACCGTT
CGTGTGAGAAT -> GTGTGAGAATT
CGTGTTCGGGG -> GTGTTCGGGGA
CGTGTTGCCAG -> GTGTTGCCAGT
CGTTAATCCAG -> GTTAATCCAGC
CGTTATCAACA -> GTTATCAACAA
CGTTATTCATC -> GTTATTCATCA
CGTTCTTACTC -> GTTCTTACTCG
CGTTTCGCTGA -> GTTTCGCTGAG
CGTTTCTTTCT -> GTTTCTTTCTT
CTAAAACGCCG -> TAAAACGCCGA
CTAAACGAGCT -> TAAACGAGCTT
CTAAATGCCTG -> TAAATGCCTGC
CTAAGTGACTG -> TAAGTGACTGA
CTAATAGTTGC -> TAATAGTTGCT
CTAATGCAGAC -> TAATGCAGACC
CTAATGGCTAT -> TAATGGCTATG
CTACAAGCAGA -> TACAAGCAGAA
CTACACCTGAC -> TACACCTGACA
CTACCTTTTTA -> TACCTTTTTAT
CTACGTCCTTC -> TACGTCCTTCT
CTACGTGATGC -> TACGTGATGCA
CTACTGGGTTC -> TACTGGGTTCA
CTACTTCTACA -> TACTTCTACAA
CTAGAATGGGC -> TAGAATGGGCG
CTAGGAGAATG -> TAGGAGAATGT
CTAGGAGGACT -> TAGGAGGACTA
CTAGGGGGGTG -> TAGGGGGGTGT
CTAGGTACCGC -> TAGGTACCGCG
CTAGGTTTTCT -> TAGGTTTTCTG
CTAGTAGCTAC -> TAGTAGCTACG
CTATAATAGGC -> TATAATAGGCC
CTATACAGAGC -> TATACAGAGCG
CTATCGTAACG -> TATCGTAACGT
CTATCTAAATG -> TATCTAAATGC
CTATGAAAGTG -> TATGAAAGTGT
CTATGCTCGGG -> TATGCTCGGGA
CTATGTTCAGG -> TATGTTCAGGG
CTATTAACAGG -> TATTAACAGGG
CTATTGCCAGG -> TATTGCCAGGG
CTATTGGAGGT -> TATTGGAGGTA
CTATTGGGGTC -> TATTGGGGTCC
CTCAACGTTAT -> TCAACGTTATC
CTCACCCTTCA -> TCACCCTTCAC
CTCAGAGTTAG -> TCAGAGTTAGT
CTCAGGGAATA -> TCAGGGAATAG
CTCAGTAGGAG -> TCAGTAGGAGA
CTCCCAGTGTG -> TCCCAGTGTGT
CTCCCATTCCT -> TCCCATTCCTA
CTCCCGCTATT -> TCCCGCTATTA
CTCCCTTGAGC -> TCCCTTGAGCC
CTCCGCGAGAT -> TCCGCGAGATT
CTCCTCGAGTA -> TCCTCGAGTAC
CTCGACCCCAG -> TCGACCCCAGC
CTCGAGTACGA -> TCGAGTACGAC
CTCGATGAACT -> TCGATGAACTT
CTCGATTATAC -> TCGATTATACT
CTCGCCAATAG -> TCGCCAATAGA
CTCGGGATCTG -> TCGGGATCTGT
CTCGGGCTCAG -> TCGGGCTCAGA
CTCGGTGCCGC -> TCGGTGCCGCT
CTCGTGATGCG -> TCGTGATGCGG
CTCGTGATTGG -> TCGTGATTGGA
CTCTAGGAGAA -> TCTAGGAGAAT
CTCTATGAAAG -> TCTATGAAAGT
CTCTCTAGGAG -> TCTCTAGGAGA
CTCTGCTTTCA -> TCTGCTTTCAC
CTCTTACTAAG -> TCTTACTAAGT
CTCTTCGAATT -> TCTTCGAATTG
CTGACAAAGCT -> TGACAAAGCTC
CTGACCCCGGT -> TGACCCCGGTT
CTGACCGCATA -> TGACCGCATAA
CTGACTGCATG -> TGACTGCATGG
CTGAGAAAATC -> TGAGAAAATCG
CTGAGAATAGA -> TGAGAATAGAC
CTGAGGAATAG -> TGAGGAATAGC
CTGAGGCAATT -> TGAGGCAATTG
CTGAGTACATG -> TGAGTACATGC
CTGAGTCCGGC -> TGAGTCCGGCT
CTGCAGACCCA -> TGCAGACCCAT
CTGCATGGTCC -> TGCATGGTCCT
CTGCCAAACCC -> TGCCAAACCCC
CTGCCTTGCCC -> TGCCTTGCCCC
CTGCTTTCACT -> TGCTTTCACTC
CTGGACGGTGG -> TGGACGGTGGT
CTGGGTACTTC -> TGGGTACTTCC
CTGGGTTCATT -> TGGGTTCATTG
CTGGTTAGCTC -> TGGTTAGCTCG
CTGTCGCACTA -> TGTCGCACTAC
CTGTCTTGTGC -> TGTCTTGTGCC
CTGTGACCCCG -> TGTGACCCCGA
CTGTGTGCCGA -> TGTGTGCCGAC
CTGTGTTAGGT -> TGTGTTAGGTA
CTGTTGTGAAT -> TGTTGTGAATC
CTGTTTGCAAG -> TGTTTGCAAGA
CTTAAAAGCGC -> TTAAAAGCGCC
CTTAACTCGTG -> TTAACTCGTGA
CTTACTAAGTG -> TTACTAAGTGA
CTTACTCGATT -> TTACTCGATTA
CTTACTGTTTG -> TTACTGTTTGC
CTTAGTTGCTA -> TTAGTTGCTAT
CTTCAAACAGT -> TTCAAACAGTT
CTTCACGGGCT -> TTCACGGGCTG
CTTCAGTATAT -> TTCAGTATATC
CTTCATTAGGG -> TTCATTAGGGC
CTTCCCACTCC -> TTCCCACTCCC
CTTCGAATTGG -> TTCGAATTGGT
CTTCGATAGTC -> TTCGATAGTCG
CTTCGCATTCT -> TTCGCATTCTT
CTTCGGCTAAT -> TTCGGCTAATG
CTTCGGTAAGT -> TTCGGTAAGTA
CTTCGTCCTTA -> TTCGTCCTTAC
CTTCTACAAGC -> TTCTACAAGCA
CTTCTACTTCT -> TTCTACTTCTA
CTTGAATCCCT -> TTGAATCCCTA
CTTGAGCCCAA -> TTGAGCCCAAG
CTTGCCCCTGT -> TTGCCCCTGTG
CTTGGGTTACG -> TTGGGTTACGA
CTTGTGCCATT -> TTGTGCCATTA
CTTGTGCCGGT -> TTGTGCCGGTG
CTTTCACTCCC -> TTTCACTCCCA
CTTTCCAAAGG -> TTTCCAAAGGC
CTTTCGACATG -> TTTCGACATGG
CTTTCTTCAAA -> TTTCTTCAAAC
CTTTGCGGGTG -> TTTGCGGGTGC
CTTTTCAAAGT -> TTTTCAAAGTA
CTTTTTATTCA -> TTTTTATTCAG
GAAAATCGGAT -> AAAATCGGATT
GAAACTGAGTC -> AAACTGAGTCC
GAAAGACGGAG -> AAAGACGGAGC
GAAAGGCAGCA -> AAAGGCAGCAA
GAAAGTGTTCC -> AAAGTGTTCCG
GAAATATATGA -> AAATATATGAC
GAAATCCCTGG -> AAATCCCTGGT
GAAATCTCTGC -> AAATCTCTGCT
GAAATGGTCGC -> AAATGGTCGCT
GAACAGGTCAT -> AACAGGTCATG
GAACCCCTGGA -> AACCCCTGGAC
GAACCTAATGC -> AACCTAATGCA
GAACCTGCCAA -> AACCTGCCAAA
GAACGACACGA -> AACGACACGAC
GAACGCATCTC -> AACGCATCTCG
GAACTTCGGTA -> AACTTCGGTAA
GAAGCCAATAC -> AAGCCAATACC
GAAGGATACAA -> AAGGATACAAA
GAAGGCGACCA -> AAGGCGACCAG
GAAGTTCTAGG -> AAGTTCTAGGG
GAATAACATGG -> AATAACATGGA
GAATAGACGAC -> AATAGACGACG
GAATAGCCCTT -> AATAGCCCTTT
GAATAGGGTAG -> AATAGGGTAGA
GAATCCCTATA -> AATCCCTATAC
GAATCGATTGC -> AATCGATTGCC
GAATCGCGGTC -> AATCGCGGTCT
GAATCGTGTTG -> AATCGTGTTGC
GAATGACTTCG -> AATGACTTCGA
GAATGGGCGAA -> AATGGGCGAAA
GAATGTTATTA -> AATGTTATTAG
GAATTATCATA -> AATTATCATAT
GAATTGGTGAT -> AATTGGTGATA
GACAAAGCTCA -> ACAAAGCTCAG
GACACCAAATA -> ACACCAAATAC
GACACGACATA -> ACACGACATAT
GACAGTTCCAG -> ACAGTTCCAGC
GACATATAATA -> ACATATAATAT
GACATATCGCC -> ACATATCGCCA
GACATGGAAGT -> ACATGGAAGTT
GACCAGAGATC -> ACCAGAGATCC
GACCAGCCAGG -> ACCAGCCAGGA
GACCATCTTGG -> ACCATCTTGGG
GACCCATAGAT -> ACCCATAGATC
GACCCCAGCTG -> ACCCCAGCTGA
GACCCCGATTT -> ACCCCGATTTG
GACCCCGGTTC -> ACCCCGGTTCG
GACCGACTTCG -> ACCGACTTCGC
GACCGCATAAG -> ACCGCATAAGC
GACCTACACCT -> ACCTACACCTG
GACCTTCGTCC -> ACCTTCGTCCT
GACGACGCCAT -> ACGACGCCATA
GACGAGAGTGA -> ACGAGAGTGAG
GACGCCATACC -> ACGCCATACCT
GACGCCATAGT -> ACGCCATAGTT
GACGCCGCTGT -> ACGCCGCTGTC
GACGGAGCGAT -> ACGGAGCGATG
GACGGCGGATG -> ACGGCGGATGG
GACGGGATTCT -> ACGGGATTCTC
GACGGGTAATC -> ACGGGTAATCC
GACGGTGGTAG -> ACGGTGGTAGC
GACGTGGCACC -> ACGTGGCACCG
GACTAATAGTT -> ACTAATAGTTG
GACTATTGGAG -> ACTATTGGAGG
GACTCCCTTGA -> ACTCCCTTGAG
GACTGACCCCG -> ACTGACCCCGG
GACTGCATGGT -> ACTGCATGGTC
GACTTAACTCG -> ACTTAACTCGT
GACTTCAGTAT -> ACTTCAGTATA
GACTTCGATAG -> ACTTCGATAGT
GACTTCGCATT -> ACTTCGCATTC
GAGAAAATCGG -> AGAAAATCGGA
GAGAACCTAAT -> AGAACCTAATG
GAGAATAGACG -> AGAATAGACGA
GAGAATGTTAT -> AGAATGTTATT
GAGAATTATCA -> AGAATTATCAT
GAGAGCGGAAA -> AGAGCGGAAAC
GAGAGTGAGCC -> AGAGTGAGCCT
GAGATCCGATC -> AGATCCGATCC
GAGATTGGGAA -> AGATTGGGAAC
GAGCATAGGAA -> AGCATAGGAAT
GAGCCCAAGGT -> AGCCCAAGGTG
GAGCCTAAAAC -> AGCCTAAAACG
GAGCGATGAGT -> AGCGATGAGTT
GAGCGGAAACT -> AGCGGAAACTG
GAGCGTCTACC -> AGCGTCTACCT
GAGCTTAAAAG -> AGCTTAAAAGC
GAGGAATAGCC -> AGGAATAGCCC
GAGGACTAATA -> AGGACTAATAG
GAGGCAATTGC -> AGGCAATTGCC
GAGGCGGGAAT -> AGGCGGGAATC
GAGGTACTCAG -> AGGTACTCAGT
GAGTACATGCT -> AGTACATGCTT
GAGTACGACGG -> AGTACGACGGG
GAGTCCGGCTG -> AGTCCGGCTGG
GAGTCGTATCA -> AGTCGTATCAG
GAGTGAGCCTA -> AGTGAGCCTAA
GAGTTAGTTTA -> AGTTAGTTTAC
GAGTTCAATTA -> AGTTCAATTAA
GAGTTGTATCG -> AGTTGTATCGT
GATAAGACGTG -> ATAAGACGTGG
GATAAGGGGTC -> ATAAGGGGTCT
GATACAAACGG -> ATACAAACGGA
GATAGCGTCGT -> ATAGCGTCGTC
GATAGTCGTCC -> ATAGTCGTCCG
GATATGCATTT -> ATATGCATTTA
GATATGGAAAG -> ATATGGAAAGA
GATATTCTTTC -> ATATTCTTTCG
GATCCGATCCG -> ATCCGATCCGT
GATCCGTCAGG -> ATCCGTCAGGC
GATCGATGCAG -> ATCGATGCAGC
GATCTCGCCAA -> ATCTCGCCAAT
GATCTGTCGCA -> ATCTGTCGCAC
GATGAACTTCG -> ATGAACTTCGG
GATGAGTTCAA -> ATGAGTTCAAT
GATGCAAACCC -> ATGCAAACCCA
GATGCAGCACT -> ATGCAGCACTT
GATGCAGCTAT -> ATGCAGCTATT
GATGCGGACAT -> ATGCGGACATA
GATGGGCTCAC -> ATGGGCTCACC
GATTAGCATTT -> ATTAGCATTTA
GATTATACCAG -> ATTATACCAGG
GATTATACTCG -> ATTATACTCGG
GATTCTCTTAC -> ATTCTCTTACT
GATTCTGAGAA -> ATTCTGAGAAT
GATTGCCCCTA -> ATTGCCCCTAG
GATTGGAGAAC -> ATTGGAGAACC
GATTGGGAACC -> ATTGGGAACCT
GATTTGACGAG -> ATTTGACGAGA
GATTTGCGTCG -> ATTTGCGTCGC
GATTTGTAATA -> ATTTGTAATAA
GATTTGTTTAA -> ATTTGTTTAAT
GCAAACCCAGC -> CAAACCCAGCA
GCAAAGTTTTC -> CAAAGTTTTCG
GCAACCGTGCG -> CAACCGTGCGG
GCAACGTGCGG -> CAACGTGCGGA
GCAACTACGTC -> CAACTACGTCC
GCAAGAGTTGT -> CAAGAGTTGTA
GCAAGCATATC -> CAAGCATATCC
GCAAGGGGACA -> CAAGGGGACAC
GCAATTGCCTG -> CAATTGCCTGA
GCACACATGGA -> CACACATGGAT
GCACACGACGC -> CACACGACGCC
GCACCGTTTCG -> CACCGTTTCGC
GCACGTTCTTA -> CACGTTCTTAC
GCACTACTGGG -> CACTACTGGGT
GCACTTAGTTG -> CACTTAGTTGC
GCAGAACAGGT -> CAGAACAGGTC
GCAGACCCATA -> CAGACCCATAG
GCAGACCTTCG -> CAGACCTTCGT
GCAGATAGCGT -> CAGATAGCGTC
GCAGCAACCGT -> CAGCAACCGTG
GCAGCACTTAG -> CAGCACTTAGT
GCAGCTATTGG -> CAGCTATTGGG
GCATAAGCCGG -> CATAAGCCGGC
GCATAGGAATC -> CATAGGAATCG
GCATATCCGCT -> CATATCCGCTC
GCATCTCGGTG -> CATCTCGGTGC
GCATGGTCCTA -> CATGGTCCTAT
GCATTCTTTCC -> CATTCTTTCCA
GCATTTAAGTT -> CATTTAAGTTT
GCATTTACTAG -> CATTTACTAGG
GCCAAACACCA -> CCAAACACCAT
GCCAAACCCCG -> CCAAACCCCGA
GCCAATACCTA -> CCAATACCTAT
GCCAATAGACG -> CCAATAGACGC
GCCACATTAGT -> CCACATTAGTG
GCCAGATATGG -> CCAGATATGGA
GCCAGGAAGGA -> CCAGGAAGGAT
GCCAGGGCGAT -> CCAGGGCGATG
GCCAGTCACCT -> CCAGTCACCTC
GCCATACCTAG -> CCATACCTAGA
GCCATAGTTAG -> CCATAGTTAGA
GCCATTATCGC -> CCATTATCGCG
GCCATTGTCAC -> CCATTGTCACT
GCCCAAGCAAC -> CCCAAGCAACG
GCCCAAGGTGC -> CCCAAGGTGCA
GCCCCTAGGTT -> CCCCTAGGTTT
GCCCCTGTGAC -> CCCCTGTGACC
GCCCTTGAATC -> CCCTTGAATCC
GCCCTTTTCAA -> CCCTTTTCAAA
GCCGACCATCT -> CCGACCATCTT
GCCGATTTGTT -> CCGATTTGTTT
GCCGCTGTCTT -> CCGCTGTCTTG
GCCGCTTTGCG -> CCGCTTTGCGG
GCCGGCGACTA -> CCGGCGACTAT
GCCGGTGACCA -> CCGGTGACCAG
GCCGTAAGGCG -> CCGTAAGGCGG
GCCTAAAACGC -> CCTAAAACGCC
GCCTGACCGCA -> CCTGACCGCAT
GCCTGCCTTGC -> CCTGCCTTGCC
GCCTTCATTAG -> CCTTCATTAGG
GCCTTGCCCCT -> CCTTGCCCCTG
GCGAAATCCCT -> CGAAATCCCTG
GCGACCAGAGA -> CGACCAGAGAT
GCGACCTACAC -> CGACCTACACC
GCGACTATTGG -> CGACTATTGGA
GCGAGATTGGG -> CGAGATTGGGA
GCGATGAGTTC -> CGATGAGTTCA
GCGATGCAGCA -> CGATGCAGCAC
GCGATTATACC -> CGATTATACCA
GCGCAAGGGGA -> CGCAAGGGGAC
GCGCCCAAGCA -> CGCCCAAGCAA
GCGCCTTCATT -> CGCCTTCATTA
GCGGAAACTGA -> CGGAAACTGAG
GCGGAAGGCGA -> CGGAAGGCGAC
GCGGAATAACA -> CGGAATAACAT
GCGGACATATA -> CGGACATATAA
GCGGATGGGCT -> CGGATGGGCTC
GCGGGAATCGC -> CGGGAATCGCG
GCGGGATCGAT -> CGGGATCGATG
GCGGGCTGCAG -> CGGGCTGCAGA
GCGGGTGCGCC -> CGGGTGCGCCT
GCGGGTGGAAG -> CGGGTGGAAGC
GCGGTCTGAGG -> CGGTCTGAGGC
GCGGTTAGGTC -> CGGTTAGGTCC
GCGTAGAACGC -> CGTAGAACGCA
GCGTATTAGAA -> CGTATTAGAAA
GCGTCGCGTTA -> CGTCGCGTTAT
GCGTCGTCTCT -> CGTCGTCTCTA
GCGTCTACCTT -> CGTCTACCTTT
GCGTTATTCAT -> CGTTATTCATC
GCTAATGGCTA -> CTAATGGCTAT
GCTACGTGATG -> CTACGTGATGC
GCTAGTAGCTA -> CTAGTAGCTAC
GCTATCGTAAC -> CTATCGTAACG
GCTATCTAAAT -> CTATCTAAATG
GCTATGCTCGG -> CTATGCTCGGG
GCTATTAACAG -> CTATTAACAGG
GCTATTGGGGT -> CTATTGGGGTC
GCTCACCCTTC -> CTCACCCTTCA
GCTCAGAGTTA -> CTCAGAGTTAG
GCTCAGGGAAT -> CTCAGGGAATA
GCTCGACCCCA -> CTCGACCCCAG
GCTCGATGAAC -> CTCGATGAACT
GCTCGGGATCT -> CTCGGGATCTG
GCTCTCTAGGA -> CTCTCTAGGAG
GCTGAGAAAAT -> CTGAGAAAATC
GCTGAGGAATA -> CTGAGGAATAG
GCTGCAGACCC -> CTGCAGACCCA
GCTGGGTACTT -> CTGGGTACTTC
GCTGTCTTGTG -> CTGTCTTGTGC
GCTGTGTTAGG -> CTGTGTTAGGT
GCTGTTGTGAA -> CTGTTGTGAAT
GCTTAAAAGCG -> CTTAAAAGCGC
GCTTCGGCTAA -> CTTCGGCTAAT
GCTTTCACTCC -> CTTTCACTCCC
GCTTTGCGGGT -> CTTTGCGGGTG
GGAAACTGAGT -> GAAACTGAGTC
GGAAAGACGGA -> GAAAGACGGAG
GGAAAGGCAGC -> GAAAGGCAGCA
GGAAATCTCTG -> GAAATCTCTGC
GGAACCTGCCA -> GAACCTGCCAA
GGAAGCCAATA -> GAAGCCAATAC
GGAAGGATACA -> GAAGGATACAA
GGAAGGCGACC -> GAAGGCGACCA
GGAAGTTCTAG -> GAAGTTCTAGG
GGAATAACATG -> GAATAACATGG
GGAATAGCCCT -> GAATAGCCCTT
GGAATAGGGTA -> GAATAGGGTAG
GGAATCGCGGT -> GAATCGCGGTC
GGAATCGTGTT -> GAATCGTGTTG
GGACACCAAAT -> GACACCAAATA
GGACATATAAT -> GACATATAATA
GGACGGCGGAT -> GACGGCGGATG
GGACGGTGGTA -> GACGGTGGTAG
GGACTAATAGT -> GACTAATAGTT
GGACTCCCTTG -> GACTCCCTTGA
GGAGAACCTAA -> GAGAACCTAAT
GGAGAATGTTA -> GAGAATGTTAT
GGAGAGCGGAA -> GAGAGCGGAAA
GGAGCATAGGA -> GAGCATAGGAA
GGAGCGATGAG -> GAGCGATGAGT
GGAGGACTAAT -> GAGGACTAATA
GGAGGTACTCA -> GAGGTACTCAG
GGATAAGACGT -> GATAAGACGTG
GGATAAGGGGT -> GATAAGGGGTC
GGATACAAACG -> GATACAAACGG
GGATATGCATT -> GATATGCATTT
GGATCGATGCA -> GATCGATGCAG
GGATCTGTCGC -> GATCTGTCGCA
GGATGGGCTCA -> GATGGGCTCAC
GGATTCTCTTA -> GATTCTCTTAC
GGATTTGCGTC -> GATTTGCGTCG
GGCAATTGCCT -> GCAATTGCCTG
GGCACACATGG -> GCACACATGGA
GGCACACGACG -> GCACACGACGC
GGCACCGTTTC -> GCACCGTTTCG
GGCAGCAACCG -> GCAGCAACCGT
GGCCACATTAG -> GCCACATTAGT
GGCCAGATATG -> GCCAGATATGG
GGCCCTTGAAT -> GCCCTTGAATC
GGCCGTAAGGC -> GCCGTAAGGCG
GGCGAAATCCC -> GCGAAATCCCT
GGCGACCAGAG -> GCGACCAGAGA
GGCGACTATTG -> GCGACTATTGG
GGCGATGCAGC -> GCGATGCAGCA
GGCGCAAGGGG -> GCGCAAGGGGA
GGCGGATGGGC -> GCGGATGGGCT
GGCGGGAATCG -> GCGGGAATCGC
GGCGGGTGGAA -> GCGGGTGGAAG
GGCGGTTAGGT -> GCGGTTAGGTC
GGCTAATGGCT -> GCTAATGGCTA
GGCTATGCTCG -> GCTATGCTCGG
GGCTCACCCTT -> GCTCACCCTTC
GGCTCAGAGTT -> GCTCAGAGTTA
GGCTGCAGACC -> GCTGCAGACCC
GGCTGGGTACT -> GCTGGGTACTT
GGCTGTTGTGA -> GCTGTTGTGAA
GGGAAATCTCT -> GGAAATCTCTG
GGGAACCTGCC -> GGAACCTGCCA
GGGAATAGGGT -> GGAATAGGGTA
GGGAATCGCGG -> GGAATCGCGGT
GGGACACCAAA -> GGACACCAAAT
GGGACGGCGGA -> GGACGGCGGAT
GGGACTCCCTT -> GGACTCCCTTG
GGGATAAGGGG -> GGATAAGGGGT
GGGATCGATGC -> GGATCGATGCA
GGGATCTGTCG -> GGATCTGTCGC
GGGATTCTCTT -> GGATTCTCTTA
GGGCACACATG -> GGCACACATGG
GGGCACACGAC -> GGCACACGACG
GGGCGAAATCC -> GGCGAAATCCC
GGGCGATGCAG -> GGCGATGCAGC
GGGCTCACCCT -> GGCTCACCCTT
GGGCTCAGAGT -> GGCTCAGAGTT
GGGCTGCAGAC -> GGCTGCAGACC
GGGCTGTTGTG -> GGCTGTTGTGA
GGGGACACCAA -> GGGACACCAAA
GGGGACTCCCT -> GGGACTCCCTT
GGGGATAAGGG -> GGGATAAGGGG
GGGGGGTGTAT -> GGGGGTGTATC
GGGGGTGTATC -> GGGGTGTATCC
GGGGTCCCCGT -> GGGTCCCCGTG
GGGGTCTGACT -> GGGTCTGACTG
GGGGTGTATCC -> GGGTGTATCCA
GGGTAATCCCC -> GGTAATCCCCG
GGGTACTTCCC -> GGTACTTCCCA
GGGTAGACAGT -> GGTAGACAGTT
GGGTCCCCGTG -> GGTCCCCGTGA
GGGTCTGACTG -> GGTCTGACTGC
GGGTGCGCCTT -> GGTGCGCCTTC
GGGTGCGTATT -> GGTGCGTATTA
GGGTGGAAGCC -> GGTGGAAGCCA
GGGTGGGTGCG -> GGTGGGTGCGT
GGGTGTATCCA -> GGTGTATCCAT
GGGTTACGACG -> GGTTACGACGG
GGGTTCATTGG -> GGTTCATTGGT
GGTAAGTATAG -> GTAAGTATAGT
GGTAATCCCCG -> GTAATCCCCGC
GGTACCGCGGA -> GTACCGCGGAA
GGTACTCAGTA -> GTACTCAGTAG
GGTACTTCCCA -> GTACTTCCCAC
GGTAGACAGTT -> GTAGACAGTTC
GGTAGCAAGCA -> GTAGCAAGCAT
GGTATGATTTG -> GTATGATTTGT
GGTCACGTAAT -> GTCACGTAATA
GGTCATGCTAT -> GTCATGCTATC
GGTCCCCGTGA -> GTCCCCGTGAA
GGTCCGGCCCT -> GTCCGGCCCTT
GGTCCTATGTT -> GTCCTATGTTC
GGTCCTATTGC -> GTCCTATTGCC
GGTCGCTCGAC -> GTCGCTCGACC
GGTCTGACTGC -> GTCTGACTGCA
GGTCTGAGGCA -> GTCTGAGGCAA
GGTGACCAGCC -> GTGACCAGCCA
GGTGATATTCT -> GTGATATTCTT
GGTGCAACTAC -> GTGCAACTACG
GGTGCCGCTTT -> GTGCCGCTTTG
GGTGCGCCTTC -> GTGCGCCTTCA
GGTGCGTATTA -> GTGCGTATTAG
GGTGGAAGCCA -> GTGGAAGCCAA
GGTGGGTGCGT -> GTGGGTGCGTA
GGTGGTAGCAA -> GTGGTAGCAAG
GGTGTATCCAT -> GTGTATCCATT
GGTTAATACTC -> GTTAATACTCT
GGTTACGACGG -> GTTACGACGGG
GGTTACTCAAC -> GTTACTCAACG
GGTTAGCTCGA -> GTTAGCTCGAT
GGTTAGGTCCG -> GTTAGGTCCGG
GGTTCATTGGT -> GTTCATTGGTC
GGTTCGTGATT -> GTTCGTGATTC
GGTTCTGTGTG -> GTTCTGTGTGC
GGTTTTCTGAG -> GTTTTCTGAGT
GTAACGTTAAT -> TAACGTTAATC
GTAAGGCGGTT -> TAAGGCGGTTA
GTAAGTATAGT -> TAAGTATAGTA
GTAATAATAGC -> TAATAATAGCG
GTAATATGCGG -> TAATATGCGGG
GTAATCCCCGC -> TAATCCCCGCA
GTACATGCTTC -> TACATGCTTCG
GTACCGCGGAA -> TACCGCGGAAG
GTACGACGGGA -> TACGACGGGAT
GTACTCAGTAG -> TACTCAGTAGG
GTACTTCCCAC -> TACTTCCCACT
GTAGAACGCAT -> TAGAACGCATC
GTAGACAGTTC -> TAGACAGTTCC
GTAGCAAGCAT -> TAGCAAGCATA
GTAGCTACGTG -> TAGCTACGTGA
GTAGGAGAGCG -> TAGGAGAGCGG
GTAGGCGGGTG -> TAGGCGGGTGG
GTATAGTATCG -> TATAGTATCGG
GTATATCCGTG -> TATATCCGTGT
GTATCAGGTCC -> TATCAGGTCCT
GTATCCATTAC -> TATCCATTACC
GTATCGGTTAC -> TATCGGTTACT
GTATCGTTTCT -> TATCGTTTCTT
GTATGATTTGT -> TATGATTTGTA
GTATTAGAAAT -> TATTAGAAATG
GTCAAGATTAG -> TCAAGATTAGC
GTCACCTCGTG -> TCACCTCGTGA
GTCACGTAATA -> TCACGTAATAT
GTCACTAAACG -> TCACTAAACGA
GTCAGGCCGTA -> TCAGGCCGTAA
GTCATGCTATC -> TCATGCTATCT
GTCCCCGTGAA -> TCCCCGTGAAA
GTCCGGCCCTT -> TCCGGCCCTTG
GTCCGGCTGGG -> TCCGGCTGGGT
GTCCGGTTCTG -> TCCGGTTCTGT
GTCCTATGTTC -> TCCTATGTTCA
GTCCTATTGCC -> TCCTATTGCCA
GTCCTTACTGT -> TCCTTACTGTT
GTCCTTCTACT -> TCCTTCTACTT
GTCGCACTACT -> TCGCACTACTG
GTCGCGTTATT -> TCGCGTTATTC
GTCGCTCGACC -> TCGCTCGACCC
GTCGTATCAGG -> TCGTATCAGGT
GTCGTCCGGTT -> TCGTCCGGTTC
GTCGTCTCTAT -> TCGTCTCTATG
GTCTACCTTTT -> TCTACCTTTTT
GTCTCTATGAA -> TCTCTATGAAA
GTCTGACTGCA -> TCTGACTGCAT
GTCTGAGGCAA -> TCTGAGGCAAT
GTCTTGTGCCA -> TCTTGTGCCAT
GTGAAATATAT -> TGAAATATATG
GTGAATCGATT -> TGAATCGATTG
GTGAATGACTT -> TGAATGACTTC
GTGACCAGCCA -> TGACCAGCCAG
GTGACCCCGAT -> TGACCCCGATT
GTGACTGACCC -> TGACTGACCCC
GTGAGAATTAT -> TGAGAATTATC
GTGAGCCTAAA -> TGAGCCTAAAA
GTGAGGCGGGA -> TGAGGCGGGAA
GTGATATTCTT -> TGATATTCTTT
GTGATGCAAAC -> TGATGCAAACC
GTGATGCGGAC -> TGATGCGGACA
GTGATTCTGAG -> TGATTCTGAGA
GTGATTGGAGA -> TGATTGGAGAA
GTGCAACTACG -> TGCAACTACGT
GTGCCATTATC -> TGCCATTATCG
GTGCCGACCAT -> TGCCGACCATC
GTGCCGCTTTG -> TGCCGCTTTGC
GTGCCGGTGAC -> TGCCGGTGACC
GTGCGATTATA -> TGCGATTATAC
GTGCGCCTTCA -> TGCGCCTTCAT
GTGCGGAATAA -> TGCGGAATAAC
GTGCGGGATCG -> TGCGGGATCGA
GTGCGTATTAG -> TGCGTATTAGA
GTGGAAGCCAA -> TGGAAGCCAAT
GTGGCACCGTT -> TGGCACCGTTT
GTGGGTGCGTA -> TGGGTGCGTAT
GTGGTAGCAAG -> TGGTAGCAAGC
GTGTATCCATT -> TGTATCCATTA
GTGTGAGAATT -> TGTGAGAATTA
GTGTGCCGACC -> TGTGCCGACCA
GTGTGTTCACT -> TGTGTTCACTT
GTGTTAGGTAT -> TGTTAGGTATG
GTGTTCACTTG -> TGTTCACTTGT
GTGTTCCGGTT -> TGTTCCGGTTA
GTGTTCGGGGA -> TGTTCGGGGAC
GTGTTGCCAGT -> TGTTGCCAGTC
GTTAATACTCT -> TTAATACTCTT
GTTAATCCAGC -> TTAATCCAGCA
GTTACGACGGG -> TTACGACGGGT
GTTACTCAACG -> TTACTCAACGT
GTTAGAGTCGT -> TTAGAGTCGTA
GTTAGCTCGAT -> TTAGCTCGATG
GTTAGGTATGA -> TTAGGTATGAT
GTTAGGTCCGG -> TTAGGTCCGGC
GTTAGTTTACC -> TTAGTTTACCA
GTTATCAACAA -> TTATCAACAAC
GTTATTAGGGG -> TTATTAGGGGA
GTTATTCATCA -> TTATTCATCAG
GTTCAATTAAC -> TTCAATTAACG
GTTCACTTGTG -> TTCACTTGTGC
GTTCAGGGTGG -> TTCAGGGTGGG
GTTCATTGGTC -> TTCATTGGTCA
GTTCCAGCGAC -> TTCCAGCGACC
GTTCCGGTTAA -> TTCCGGTTAAT
GTTCGGGGACT -> TTCGGGGACTC
GTTCGTGATTC -> TTCGTGATTCT
GTTCTAGGGGG -> TTCTAGGGGGG
GTTCTCCTCGA -> TTCTCCTCGAG
GTTCTGTGTGC -> TTCTGTGTGCC
GTTCTTACTCG -> TTCTTACTCGA
GTTGAACGACA -> TTGAACGACAC
GTTGCCAGTCA -> TTGCCAGTCAC
GTTGCTATCGT -> TTGCTATCGTA
GTTGCTGTGTT -> TTGCTGTGTTA
GTTGTATCGTT -> TTGTATCGTTT
GTTGTGAATCG -> TTGTGAATCGA
GTTTAATGGGA -> TTTAATGGGAA
GTTTACCAAAT -> TTTACCAAATA
GTTTAGTGAGG -> TTTAGTGAGGC
GTTTCGCTGAG -> TTTCGCTGAGA
GTTTCTTTCTT -> TTTCTTTCTTC
GTTTGCAAGAG -> TTTGCAAGAGT
GTTTTCGACTT -> TTTTCGACTTA
GTTTTCTGAGT -> TTTTCTGAGTA
TAAAACGCCGA -> AAAACGCCGAT
TAAAAGCGCCC -> AAAAGCGCCCA
TAAACGAGCTT -> AAACGAGCTTA
TAAATGCCTGC -> AAATGCCTGCC
TAACAGGGACG -> AACAGGGACGG
TAACATGGAGC -> AACATGGAGCA
TAACGTGTTCG -> AACGTGTTCGG
TAACGTTAATC -> AACGTTAATCC
TAACTCGTGAT -> AACTCGTGATT
TAAGACGTGGC -> AAGACGTGGCA
TAAGCCGGCGA -> AAGCCGGCGAC
TAAGGCGGTTA -> AAGGCGGTTAG
TAAGGGGTCTG -> AAGGGGTCTGA
TAAGTATAGTA -> AAGTATAGTAT
TAAGTGACTGA -> AAGTGACTGAC
TAAGTTTAGTG -> AAGTTTAGTGA
TAATAATAGCG -> AATAATAGCGT
TAATACTCTTC -> AATACTCTTCG
TAATAGCGTAG -> AATAGCGTAGA
TAATAGGCCAG -> AATAGGCCAGA
TAATAGTTGCT -> AATAGTTGCTG
TAATATGCGGG -> AATATGCGGGC
TAATATTGTGC -> AATATTGTGCG
TAATCCAGCAC -> AATCCAGCACG
TAATCCCCGCA -> AATCCCCGCAG
TAATGCAGACC -> AATGCAGACCT
TAATGGCTATG -> AATGGCTATGC
TAATGGGAAAT -> AATGGGAAATC
TACAAACGGAA -> ACAAACGGAAA
TACAAGCAGAA -> ACAAGCAGAAC
TACACCTGACA -> ACACCTGACAA
TACAGAGCGTC -> ACAGAGCGTCT
TACATGCTTCG -> ACATGCTTCGG
TACCAAATAGT -> ACCAAATAGTT
TACCAGGATAT -> ACCAGGATATG
TACCGCGGAAG -> ACCGCGGAAGG
TACCTAGAATG -> ACCTAGAATGG
TACCTATAATA -> ACCTATAATAG
TACCTCCGCGA -> ACCTCCGCGAG
TACCTTTTTAT -> ACCTTTTTATT
TACGACGGGAT -> ACGACGGGATT
TACGACGGGTA -> ACGACGGGTAA
TACGTCCTTCT -> ACGTCCTTCTA
TACGTGATGCA -> ACGTGATGCAA
TACTAAGTGAC -> ACTAAGTGACT
TACTAGGAGGA -> ACTAGGAGGAC
TACTCAACGTT -> ACTCAACGTTA
TACTCAGTAGG -> ACTCAGTAGGA
TACTCCCAGTG -> ACTCCCAGTGT
TACTCGATTAT -> ACTCGATTATA
TACTCGGGCTC -> ACTCGGGCTCA
TACTCTTCGAA -> ACTCTTCGAAT
TACTGGGTTCA -> ACTGGGTTCAT
TACTGTTTGCA -> ACTGTTTGCAA
TACTTCCCACT -> ACTTCCCACTC
TACTTCTACAA -> ACTTCTACAAG
TAGAAATGGTC -> AGAAATGGTCG
TAGAACGCATC -> AGAACGCATCT
TAGAATGGGCG -> AGAATGGGCGA
TAGACAGTTCC -> AGACAGTTCCA
TAGACGACGCC -> AGACGACGCCA
TAGACGCCGCT -> AGACGCCGCTG
TAGAGTCGTAT -> AGAGTCGTATC
TAGATCTCGCC -> AGATCTCGCCA
TAGCAAGCATA -> AGCAAGCATAT
TAGCATTTACT -> AGCATTTACTA
TAGCCCTTTTC -> AGCCCTTTTCA
TAGCGTAGAAC -> AGCGTAGAACG
TAGCGTCGTCT -> AGCGTCGTCTC
TAGCTACGTGA -> AGCTACGTGAT
TAGCTCGATGA -> AGCTCGATGAA
TAGGAATCGTG -> AGGAATCGTGT
TAGGAGAATGT -> AGGAGAATGTT
TAGGAGAGCGG -> AGGAGAGCGGA
TAGGAGGACTA -> AGGAGGACTAA
TAGGCCAGATA -> AGGCCAGATAT
TAGGCGGGTGG -> AGGCGGGTGGA
TAGGGCACACA -> AGGGCACACAT
TAGGGGATAAG -> AGGGGATAAGG
TAGGGGGGTGT -> AGGGGGGTGTA
TAGGGTAGACA -> AGGGTAGACAG
TAGGTACCGCG -> AGGTACCGCGG
TAGGTATGATT -> AGGTATGATTT
TAGGTCCGGCC -> AGGTCCGGCCC
TAGGTTTTCTG -> AGGTTTTCTGA
TAGTAGCTACG -> AGTAGCTACGT
TAGTATCGGTT -> AGTATCGGTTA
TAGTCGTCCGG -> AGTCGTCCGGT
TAGTGAATGAC -> AGTGAATGACT
TAGTGAGGCGG -> AGTGAGGCGGG
TAGTTAGAGTC -> AGTTAGAGTCG
TAGTTGAACGA -> AGTTGAACGAC
TAGTTGCTATC -> AGTTGCTATCG
TAGTTGCTGTG -> AGTTGCTGTGT
TAGTTTACCAA -> AGTTTACCAAA
TATAATAGGCC -> ATAATAGGCCA
TATAATATTGT -> ATAATATTGTG
TATACAGAGCG -> ATACAGAGCGT
TATACCAGGAT -> ATACCAGGATA
TATACTCGGGC -> ATACTCGGGCT
TATAGTATCGG -> ATAGTATCGGT
TATATCCGTGT -> ATATCCGTGTG
TATATGACTTC -> ATATGACTTCA
TATCAACAACA -> ATCAACAACAG
TATCAGGTCCT -> ATCAGGTCCTA
TATCATATCCG -> ATCATATCCGC
TATCCATTACC -> ATCCATTACCT
TATCCGCTAGT -> ATCCGCTAGTA
TATCCGCTCTC -> ATCCGCTCTCT
TATCCGTGTGA -> ATCCGTGTGAG
TATCGCCATTG -> ATCGCCATTGT
TATCGCGACCT -> ATCGCGACCTA
TATCGGTTACT -> ATCGGTTACTC
TATCGTAACGT -> ATCGTAACGTT
TATCGTTTCTT -> ATCGTTTCTTT
TATCTAAATGC -> ATCTAAATGCC
TATGAAAGTGT -> ATGAAAGTGTT
TATGACTTCAG -> ATGACTTCAGT
TATGATTTGTA -> ATGATTTGTAA
TATGCATTTAA -> ATGCATTTAAG
TATGCGGGCTG -> ATGCGGGCTGC
TATGCTCGGGA -> ATGCTCGGGAT
TATGGAAAGAC -> ATGGAAAGACG
TATGTTCAGGG -> ATGTTCAGGGT
TATTAACAGGG -> ATTAACAGGGA
TATTAGAAATG -> ATTAGAAATGG
TATTAGGGGAT -> ATTAGGGGATA
TATTCAGACCG -> ATTCAGACCGA
TATTCATCAGC -> ATTCATCAGCC
TATTCTTTCGA -> ATTCTTTCGAC
TATTGCCAGGG -> ATTGCCAGGGC
TATTGGAGGTA -> ATTGGAGGTAC
TATTGGGGTCC -> ATTGGGGTCCC
TATTGTGCGAT -> ATTGTGCGATT
TCAAACAGTTC -> CAAACAGTTCT
TCAAAGTAGGC -> CAAAGTAGGCG
TCAACAACAGG -> CAACAACAGGG
TCAACGTTATC -> CAACGTTATCA
TCAAGATTAGC -> CAAGATTAGCA
TCAATTAACGT -> CAATTAACGTG
TCACCCTTCAC -> CACCCTTCACG
TCACCTCGTGA -> CACCTCGTGAT
TCACGGGCTGT -> CACGGGCTGTT
TCACGTAATAT -> CACGTAATATG
TCACTAAACGA -> CACTAAACGAG
TCACTCCCATT -> CACTCCCATTC
TCACTTGTGCC -> CACTTGTGCCG
TCAGACCGACT -> CAGACCGACTT
TCAGAGTTAGT -> CAGAGTTAGTT
TCAGCCAAACA -> CAGCCAAACAC
TCAGGCCGTAA -> CAGGCCGTAAG
TCAGGGAATAG -> CAGGGAATAGG
TCAGGGTGGGT -> CAGGGTGGGTG
TCAGGTCCTAT -> CAGGTCCTATT
TCAGTAGGAGA -> CAGTAGGAGAG
TCAGTATATCC -> CAGTATATCCG
TCATATCCGCT -> CATATCCGCTA
TCATCAGCCAA -> CATCAGCCAAA
TCATGCTATCT -> CATGCTATCTA
TCATTAGGGCA -> CATTAGGGCAC
TCATTGGTCAC -> CATTGGTCACG
TCCAAAGGCGC -> CCAAAGGCGCA
TCCAGCACGTT -> CCAGCACGTTC
TCCATTACCTC -> CCATTACCTCC
TCCCACTCCCG -> CCCACTCCCGC
TCCCAGTGTGT -> CCCAGTGTGTT
TCCCATTCCTA -> CCCATTCCTAG
TCCCCGCAGAT -> CCCCGCAGATA
TCCCCGTGAAA -> CCCCGTGAAAT
TCCCGCTATTA -> CCCGCTATTAA
TCCCTATACAG -> CCCTATACAGA
TCCCTGGTTAG -> CCCTGGTTAGC
TCCCTTGAGCC -> CCCTTGAGCCC
TCCGATCCGTC -> CCGATCCGTCA
TCCGCGAGATT -> CCGCGAGATTG
TCCGCTAGTAG -> CCGCTAGTAGC
TCCGCTCTCTA -> CCGCTCTCTAG
TCCGGCCCTTG -> CCGGCCCTTGA
TCCGGCTGGGT -> CCGGCTGGGTA
TCCGGTTAATA -> CCGGTTAATAC
TCCGGTTCTGT -> CCGGTTCTGTG
TCCGTCAGGCC -> CCGTCAGGCCG
TCCGTGTGAGA -> CCGTGTGAGAA
TCCTAGGTACC -> CCTAGGTACCG
TCCTATGTTCA -> CCTATGTTCAG
TCCTATTGCCA -> CCTATTGCCAG
TCCTCGAGTAC -> CCTCGAGTACG
TCCTTACTGTT -> CCTTACTGTTT
TCCTTCTACTT -> CCTTCTACTTC
TCGAATTGGTG -> CGAATTGGTGA
TCGACATGGAA -> CGACATGGAAG
TCGACCCCAGC -> CGACCCCAGCT
TCGACTTAACT -> CGACTTAACTC
TCGAGTACGAC -> CGAGTACGACG
TCGATAGTCGT -> CGATAGTCGTC
TCGATGAACTT -> CGATGAACTTC
TCGATGCAGCT -> CGATGCAGCTA
TCGATTATACT -> CGATTATACTC
TCGATTGCCCC -> CGATTGCCCCT
TCGCACTACTG -> CGCACTACTGG
TCGCATTCTTT -> CGCATTCTTTC
TCGCCAATAGA -> CGCCAATAGAC
TCGCCATTGTC -> CGCCATTGTCA
TCGCGACCTAC -> CGCGACCTACA
TCGCGGTCTGA -> CGCGGTCTGAG
TCGCGTTATTC -> CGCGTTATTCA
TCGCTCGACCC -> CGCTCGACCCC
TCGCTGAGAAA -> CGCTGAGAAAA
TCGGATTTGCG -> CGGATTTGCGT
TCGGCTAATGG -> CGGCTAATGGC
TCGGGATCTGT -> CGGGATCTGTC
TCGGGCTCAGA -> CGGGCTCAGAG
TCGGGGACTCC -> CGGGGACTCCC
TCGGTAAGTAT -> CGGTAAGTATA
TCGGTGCCGCT -> CGGTGCCGCTT
TCGGTTACTCA -> CGGTTACTCAA
TCGTAACGTTA -> CGTAACGTTAA
TCGTATCAGGT -> CGTATCAGGTC
TCGTCAAGATT -> CGTCAAGATTA
TCGTCCGGTTC -> CGTCCGGTTCT
TCGTCCTTACT -> CGTCCTTACTG
TCGTCTCTATG -> CGTCTCTATGA
TCGTGATGCGG -> CGTGATGCGGA
TCGTGATTCTG -> CGTGATTCTGA
TCGTGATTGGA -> CGTGATTGGAG
TCGTGTTGCCA -> CGTGTTGCCAG
TCGTTTCTTTC -> CGTTTCTTTCT
TCTAAATGCCT -> CTAAATGCCTG
TCTACAAGCAG -> CTACAAGCAGA
TCTACCTTTTT -> CTACCTTTTTA
TCTACTTCTAC -> CTACTTCTACA
TCTAGGAGAAT -> CTAGGAGAATG
TCTAGGGGGGT -> CTAGGGGGGTG
TCTATGAAAGT -> CTATGAAAGTG
TCTCCTCGAGT -> CTCCTCGAGTA
TCTCGCCAATA -> CTCGCCAATAG
TCTCGGTGCCG -> CTCGGTGCCGC
TCTCTAGGAGA -> CTCTAGGAGAA
TCTCTATGAAA -> CTCTATGAAAG
TCTCTGCTTTC -> CTCTGCTTTCA
TCTCTTACTAA -> CTCTTACTAAG
TCTGACTGCAT -> CTGACTGCATG
TCTGAGAATAG -> CTGAGAATAGA
TCTGAGGCAAT -> CTGAGGCAATT
TCTGAGTACAT -> CTGAGTACATG
TCTGCTTTCAC -> CTGCTTTCACT
TCTGTCGCACT -> CTGTCGCACTA
TCTGTGTGCCG -> CTGTGTGCCGA
TCTTACTAAGT -> CTTACTAAGTG
TCTTACTCGAT -> CTTACTCGATT
TCTTCAAACAG -> CTTCAAACAGT
TCTTCGAATTG -> CTTCGAATTGG
TCTTGGGTTAC -> CTTGGGTTACG
TCTTGTGCCAT -> CTTGTGCCATT
TCTTTCCAAAG -> CTTTCCAAAGG
TCTTTCGACAT -> CTTTCGACATG
TCTTTCTTCAA -> CTTTCTTCAAA
TGAAAGTGTTC -> GAAAGTGTTCC
TGAAATATATG -> GAAATATATGA
TGAACGACACG -> GAACGACACGA
TGAACTTCGGT -> GAACTTCGGTA
TGAATCCCTAT -> GAATCCCTATA
TGAATCGATTG -> GAATCGATTGC
TGAATGACTTC -> GAATGACTTCG
TGACAAAGCTC -> GACAAAGCTCA
TGACCAGCCAG -> GACCAGCCAGG
TGACCCCGATT -> GACCCCGATTT
TGACCCCGGTT -> GACCCCGGTTC
TGACCGCATAA -> GACCGCATAAG
TGACGAGAGTG -> GACGAGAGTGA
TGACTGACCCC -> GACTGACCCCG
TGACTGCATGG -> GACTGCATGGT
TGACTTCAGTA -> GACTTCAGTAT
TGACTTCGATA -> GACTTCGATAG
TGAGAAAATCG -> GAGAAAATCGG
TGAGAATAGAC -> GAGAATAGACG
TGAGAATTATC -> GAGAATTATCA
TGAGCCCAAGG -> GAGCCCAAGGT
TGAGCCTAAAA -> GAGCCTAAAAC
TGAGGAATAGC -> GAGGAATAGCC
TGAGGCAATTG -> GAGGCAATTGC
TGAGGCGGGAA -> GAGGCGGGAAT
TGAGTACATGC -> GAGTACATGCT
TGAGTCCGGCT -> GAGTCCGGCTG
TGAGTTCAATT -> GAGTTCAATTA
TGATATTCTTT -> GATATTCTTTC
TGATGCAAACC -> GATGCAAACCC
TGATGCGGACA -> GATGCGGACAT
TGATTCTGAGA -> GATTCTGAGAA
TGATTGGAGAA -> GATTGGAGAAC
TGATTTGTAAT -> GATTTGTAATA
TGCAAACCCAG -> GCAAACCCAGC
TGCAACTACGT -> GCAACTACGTC
TGCAAGAGTTG -> GCAAGAGTTGT
TGCAGACCCAT -> GCAGACCCATA
TGCAGACCTTC -> GCAGACCTTCG
TGCAGCACTTA -> GCAGCACTTAG
TGCAGCTATTG -> GCAGCTATTGG
TGCATGGTCCT -> GCATGGTCCTA
TGCATTTAAGT -> GCATTTAAGTT
TGCCAAACCCC -> GCCAAACCCCG
TGCCAGGGCGA -> GCCAGGGCGAT
TGCCAGTCACC -> GCCAGTCACCT
TGCCATTATCG -> GCCATTATCGC
TGCCCCTAGGT -> GCCCCTAGGTT
TGCCCCTGTGA -> GCCCCTGTGAC
TGCCGACCATC -> GCCGACCATCT
TGCCGCTTTGC -> GCCGCTTTGCG
TGCCGGTGACC -> GCCGGTGACCA
TGCCTGACCGC -> GCCTGACCGCA
TGCCTGCCTTG -> GCCTGCCTTGC
TGCCTTGCCCC -> GCCTTGCCCCT
TGCGATTATAC -> GCGATTATACC
TGCGCCTTCAT -> GCGCCTTCATT
TGCGGAATAAC -> GCGGAATAACA
TGCGGACATAT -> GCGGACATATA
TGCGGGATCGA -> GCGGGATCGAT
TGCGGGCTGCA -> GCGGGCTGCAG
TGCGGGTGCGC -> GCGGGTGCGCC
TGCGTATTAGA -> GCGTATTAGAA
TGCGTCGCGTT -> GCGTCGCGTTA
TGCTATCGTAA -> GCTATCGTAAC
TGCTATCTAAA -> GCTATCTAAAT
TGCTCGGGATC -> GCTCGGGATCT
TGCTGTGTTAG -> GCTGTGTTAGG
TGCTTCGGCTA -> GCTTCGGCTAA
TGCTTTCACTC -> GCTTTCACTCC
TGGAAAGACGG -> GGAAAGACGGA
TGGAAGCCAAT -> GGAAGCCAATA
TGGAAGTTCTA -> GGAAGTTCTAG
TGGACGGTGGT -> GGACGGTGGTA
TGGAGAACCTA -> GGAGAACCTAA
TGGAGCATAGG -> GGAGCATAGGA
TGGAGGTACTC -> GGAGGTACTCA
TGGATAAGACG -> GGATAAGACGT
TGGCACCGTTT -> GGCACCGTTTC
TGGCCACATTA -> GGCCACATTAG
TGGCTATGCTC -> GGCTATGCTCG
TGGGAAATCTC -> GGGAAATCTCT
TGGGAACCTGC -> GGGAACCTGCC
TGGGCGAAATC -> GGGCGAAATCC
TGGGCTCACCC -> GGGCTCACCCT
TGGGGTCCCCG -> GGGGTCCCCGT
TGGGTACTTCC -> GGGTACTTCCC
TGGGTGCGTAT -> GGGTGCGTATT
TGGGTTACGAC -> GGGTTACGACG
TGGGTTCATTG -> GGGTTCATTGG
TGGTAGCAAGC -> GGTAGCAAGCA
TGGTCACGTAA -> GGTCACGTAAT
TGGTCCTATGT -> GGTCCTATGTT
TGGTCGCTCGA -> GGTCGCTCGAC
TGGTGATATTC -> GGTGATATTCT
TGGTTAGCTCG -> GGTTAGCTCGA
TGTAATAATAG -> GTAATAATAGC
TGTATCCATTA -> GTATCCATTAC
TGTATCGTTTC -> GTATCGTTTCT
TGTCACTAAAC -> GTCACTAAACG
TGTCGCACTAC -> GTCGCACTACT
TGTCTTGTGCC -> GTCTTGTGCCA
TGTGAATCGAT -> GTGAATCGATT
TGTGACCCCGA -> GTGACCCCGAT
TGTGAGAATTA -> GTGAGAATTAT
TGTGCCATTAT -> GTGCCATTATC
TGTGCCGACCA -> GTGCCGACCAT
TGTGCCGGTGA -> GTGCCGGTGAC
TGTGCGATTAT -> GTGCGATTATA
TGTGTGCCGAC -> GTGTGCCGACC
TGTGTTAGGTA -> GTGTTAGGTAT
TGTGTTCACTT -> GTGTTCACTTG
TGTTAGGTATG -> GTTAGGTATGA
TGTTATTAGGG -> GTTATTAGGGG
TGTTCACTTGT -> GTTCACTTGTG
TGTTCAGGGTG -> GTTCAGGGTGG
TGTTCCGGTTA -> GTTCCGGTTAA
TGTTCGGGGAC -> GTTCGGGGACT
TGTTGCCAGTC -> GTTGCCAGTCA
TGTTGTGAATC -> GTTGTGAATCG
TGTTTAATGGG -> GTTTAATGGGA
TGTTTGCAAGA -> GTTTGCAAGAG
TTAAAAGCGCC -> TAAAAGCGCCC
TTAACAGGGAC -> TAACAGGGACG
TTAACGTGTTC -> TAACGTGTTCG
TTAACTCGTGA -> TAACTCGTGAT
TTAAGTTTAGT -> TAAGTTTAGTG
TTAATACTCTT -> TAATACTCTTC
TTAATCCAGCA -> TAATCCAGCAC
TTAATGGGAAA -> TAATGGGAAAT
TTACCAAATAG -> TACCAAATAGT
TTACCTCCGCG -> TACCTCCGCGA
TTACGACGGGT -> TACGACGGGTA
TTACTAAGTGA -> TACTAAGTGAC
TTACTAGGAGG -> TACTAGGAGGA
TTACTCAACGT -> TACTCAACGTT
TTACTCGATTA -> TACTCGATTAT
TTACTGTTTGC -> TACTGTTTGCA
TTAGAAATGGT -> TAGAAATGGTC
TTAGAGTCGTA -> TAGAGTCGTAT
TTAGCATTTAC -> TAGCATTTACT
TTAGCTCGATG -> TAGCTCGATGA
TTAGGGCACAC -> TAGGGCACACA
TTAGGGGATAA -> TAGGGGATAAG
TTAGGTATGAT -> TAGGTATGATT
TTAGGTCCGGC -> TAGGTCCGGCC
TTAGTGAATGA -> TAGTGAATGAC
TTAGTGAGGCG -> TAGTGAGGCGG
TTAGTTGCTAT -> TAGTTGCTATC
TTAGTTTACCA -> TAGTTTACCAA
TTATACCAGGA -> TATACCAGGAT
TTATACTCGGG -> TATACTCGGGC
TTATCAACAAC -> TATCAACAACA
TTATCATATCC -> TATCATATCCG
TTATCGCGACC -> TATCGCGACCT
TTATTAGGGGA -> TATTAGGGGAT
TTATTCAGACC -> TATTCAGACCG
TTATTCATCAG -> TATTCATCAGC
TTCAAACAGTT -> TCAAACAGTTC
TTCAAAGTAGG -> TCAAAGTAGGC
TTCAATTAACG -> TCAATTAACGT
TTCACGGGCTG -> TCACGGGCTGT
TTCACTCCCAT -> TCACTCCCATT
TTCACTTGTGC -> TCACTTGTGCC
TTCAGACCGAC -> TCAGACCGACT
TTCAGGGTGGG -> TCAGGGTGGGT
TTCAGTATATC -> TCAGTATATCC
TTCATCAGCCA -> TCATCAGCCAA
TTCATTAGGGC -> TCATTAGGGCA
TTCATTGGTCA -> TCATTGGTCAC
TTCCAAAGGCG -> TCCAAAGGCGC
TTCCCACTCCC -> TCCCACTCCCG
TTCCGGTTAAT -> TCCGGTTAATA
TTCCTAGGTAC -> TCCTAGGTACC
TTCGAATTGGT -> TCGAATTGGTG
TTCGACATGGA -> TCGACATGGAA
TTCGACTTAAC -> TCGACTTAACT
TTCGATAGTCG -> TCGATAGTCGT
TTCGCATTCTT -> TCGCATTCTTT
TTCGCTGAGAA -> TCGCTGAGAAA
TTCGGCTAATG -> TCGGCTAATGG
TTCGGGGACTC -> TCGGGGACTCC
TTCGGTAAGTA -> TCGGTAAGTAT
TTCGTCCTTAC -> TCGTCCTTACT
TTCGTGATTCT -> TCGTGATTCTG
TTCTACAAGCA -> TCTACAAGCAG
TTCTACTTCTA -> TCTACTTCTAC
TTCTAGGGGGG -> TCTAGGGGGGT
TTCTCCTCGAG -> TCTCCTCGAGT
TTCTCTTACTA -> TCTCTTACTAA
TTCTGAGAATA -> TCTGAGAATAG
TTCTGAGTACA -> TCTGAGTACAT
TTCTGTGTGCC -> TCTGTGTGCCG
TTCTTACTCGA -> TCTTACTCGAT
TTCTTCAAACA -> TCTTCAAACAG
TTCTTTCCAAA -> TCTTTCCAAAG
TTCTTTCGACA -> TCTTTCGACAT
TTCTTTCTTCA -> TCTTTCTTCAA
TTGAACGACAC -> TGAACGACACG
TTGAATCCCTA -> TGAATCCCTAT
TTGACGAGAGT -> TGACGAGAGTG
TTGAGCCCAAG -> TGAGCCCAAGG
TTGCAAGAGTT -> TGCAAGAGTTG
TTGCCAGGGCG -> TGCCAGGGCGA
TTGCCAGTCAC -> TGCCAGTCACC
TTGCCCCTAGG -> TGCCCCTAGGT
TTGCCCCTGTG -> TGCCCCTGTGA
TTGCCTGACCG -> TGCCTGACCGC
TTGCGGGTGCG -> TGCGGGTGCGC
TTGCGTCGCGT -> TGCGTCGCGTT
TTGCTATCGTA -> TGCTATCGTAA
TTGCTGTGTTA -> TGCTGTGTTAG
TTGGAGAACCT -> TGGAGAACCTA
TTGGAGGTACT -> TGGAGGTACTC
TTGGGAACCTG -> TGGGAACCTGC
TTGGGGTCCCC -> TGGGGTCCCCG
TTGGGTTACGA -> TGGGTTACGAC
TTGGTCACGTA -> TGGTCACGTAA
TTGGTGATATT -> TGGTGATATTC
TTGTAATAATA -> TGTAATAATAG
TTGTATCGTTT -> TGTATCGTTTC
TTGTCACTAAA -> TGTCACTAAAC
TTGTGAATCGA -> TGTGAATCGAT
TTGTGCCATTA -> TGTGCCATTAT
TTGTGCCGGTG -> TGTGCCGGTGA
TTGTGCGATTA -> TGTGCGATTAT
TTGTTTAATGG -> TGTTTAATGGG
TTTAAGTTTAG -> TTAAGTTTAGT
TTTAATGGGAA -> TTAATGGGAAA
TTTACCAAATA -> TTACCAAATAG
TTTACTAGGAG -> TTACTAGGAGG
TTTAGTGAGGC -> TTAGTGAGGCG
TTTATTCAGAC -> TTATTCAGACC
TTTCAAAGTAG -> TTCAAAGTAGG
TTTCACTCCCA -> TTCACTCCCAT
TTTCCAAAGGC -> TTCCAAAGGCG
TTTCGACATGG -> TTCGACATGGA
TTTCGACTTAA -> TTCGACTTAAC
TTTCGCTGAGA -> TTCGCTGAGAA
TTTCTGAGTAC -> TTCTGAGTACA
TTTCTTCAAAC -> TTCTTCAAACA
TTTCTTTCTTC -> TTCTTTCTTCA
TTTGACGAGAG -> TTGACGAGAGT
TTTGCAAGAGT -> TTGCAAGAGTT
TTTGCGGGTGC -> TTGCGGGTGCG
TTTGCGTCGCG -> TTGCGTCGCGT
TTTGTAATAAT -> TTGTAATAATA
TTTGTTTAATG -> TTGTTTAATGG
TTTTATTCAGA -> TTTATTCAGAC
TTTTCAAAGTA -> TTTCAAAGTAG
TTTTCGACTTA -> TTTCGACTTAA
TTTTCTGAGTA -> TTTCTGAGTAC
TTTTTATTCAG -> TTTTATTCAGA
