AAAAAACCTTG -> AAAAACCTTGC
AAAAACCTTGC -> AAAACCTTGCT
AAAAACTTGGT -> AAAACTTGGTT
AAAAATCCTGA -> AAAATCCTGAC
AAAACCTTGCT -> AAACCTTGCTA
AAAACTTGGTT -> AAACTTGGTTC
AAAATCCTGAC -> AAATCCTGACT
AAAATCTACAA -> AAATCTACAAT
AAAATGGGTCG -> AAATGGGTCGG
AAAATGTTTGT -> AAATGTTTGTT
AAACAGACAAT -> AACAGACAATG
AAACCATATTC -> AACCATATTCG
AAACCTTGCTA -> AACCTTGCTAC
AAACGCTGGCG -> AACGCTGGCGG
AAACTAAAGAA -> AACTAAAGAAT
AAACTTCGGGG -> AACTTCGGGGT
AAACTTGGTTC -> AACTTGGTTCC
AAACTTGTCCC -> AACTTGTCCCG
AAAGAATGGCG -> AAGAATGGCGG
AAAGACGATTT -> AAGACGATTTA
AAAGACTCTTG -> AAGACTCTTGT
AAAGGAATTTT -> AAGGAATTTTT
AAAGTATCCTG -> AAGTATCCTGC
AAAGTCATACG -> AAGTCATACGT
AAAGTTAGACC -> AAGTTAGACCT
AAATACCGGCC -> AATACCGGCCA
AAATCCTGACT -> AATCCTGACTG
AAATCGTACTA -> AATCGTACTAA
AAATCTACAAT -> AATCTACAATA
AAATCTCCGAG -> AATCTCCGAGA
AAATCTGAGAT -> AATCTGAGATG
AAATGGGTCGG -> AATGGGTCGGG
AAATGGTGCAC -> AATGGTGCACA
AAATGTTTGTT -> AATGTTTGTTC
AAATTCTGTGA -> AATTCTGTGAA
AACAAGTCGTC -> ACAAGTCGTCC
AACAGACAATG -> ACAGACAATGG
AACATTATGTC -> ACATTATGTCG
AACCAACGTCG -> ACCAACGTCGG
AACCAATATAC -> ACCAATATACC
AACCATATTCG -> ACCATATTCGG
AACCCAATAAA -> ACCCAATAAAT
AACCCCTTCCA -> ACCCCTTCCAG
AACCCTGAATT -> ACCCTGAATTT
AACCGCTGGCA -> ACCGCTGGCAT
AACCTGCTCTT -> ACCTGCTCTTA
AACCTTGCTAC -> ACCTTGCTACC
AACGACATATG -> ACGACATATGC
AACGAGTGATT -> ACGAGTGATTC
AACGCTGGCGG -> ACGCTGGCGGC
AACGCTTACGA -> ACGCTTACGAC
AACGTAATTGA -> ACGTAATTGAT
AACGTAGACCC -> ACGTAGACCCA
AACGTCGGCAG -> ACGTCGGCAGA
AACTAAAGAAT -> ACTAAAGAATG
AACTAACTTTT -> ACTAACTTTTC
AACTACAGCGA -> ACTACAGCGAT
AACTCAATAGT -> ACTCAATAGTA
AACTGCCCATA -> ACTGCCCATAC
AACTTCGGGGT -> ACTTCGGGGTG
AACTTGGTTCC -> ACTTGGTTCCG
AACTTGTCCCG -> ACTTGTCCCGC
AACTTTTCGAT -> ACTTTTCGATC
AAGAATGGCGG -> AGAATGGCGGC
AAGACATTTTG -> AGACATTTTGA
AAGACGATTTA -> AGACGATTTAT
AAGACTCTTGT -> AGACTCTTGTT
AAGAGCAGGGA -> AGAGCAGGGAT
AAGAGGCGTGA -> AGAGGCGTGAC
AAGAGTCATAG -> AGAGTCATAGA
AAGATGGGTAT -> AGATGGGTATT
AAGCCAAGCTG -> AGCCAAGCTGA
AAGCCTTAGGT -> AGCCTTAGGTT
AAGCTGACTGT -> AGCTGACTGTG
AAGCTGGACGG -> AGCTGGACGGG
AAGGAATTTTT -> AGGAATTTTTT
AAGGAGGCAGA -> AGGAGGCAGAA
AAGGATGATTT -> AGGATGATTTG
AAGGGCAGTGG -> AGGGCAGTGGT
AAGGGCGTGAC -> AGGGCGTGACC
AAGGTCCGACG -> AGGTCCGACGG
AAGGTTTTAGG -> AGGTTTTAGGG
AAGTATCACGT -> AGTATCACGTA
AAGTATCCTGC -> AGTATCCTGCA
AAGTCATACGT -> AGTCATACGTG
AAGTCCATACG -> AGTCCATACGC
AAGTCCGCTCG -> AGTCCGCTCGA
AAGTCGTCCGT -> AGTCGTCCGTT
AAGTGGTGCTA -> AGTGGTGCTAC
AAGTTAGAATG -> AGTTAGAATGG
AAGTTAGACCT -> AGTTAGACCTC
AATAAATCTGA -> ATAAATCTGAG
AATACATGGAG -> ATACATGGAGG
AATACCGACCT -> ATACCGACCTC
AATACCGGCCA -> ATACCGGCCAT
AATAGGGTGCA -> ATAGGGTGCAC
AATAGTAAGGA -> ATAGTAAGGAT
AATAGTGAAGT -> ATAGTGAAGTG
AATATAATAGG -> ATATAATAGGG
AATATACCTAA -> ATATACCTAAA
AATATTCGTGC -> ATATTCGTGCG
AATCCACCGCC -> ATCCACCGCCG
AATCCTGACTG -> ATCCTGACTGT
AATCGGTGAAG -> ATCGGTGAAGG
AATCGTACTAA -> ATCGTACTAAC
AATCTACAATA -> ATCTACAATAC
AATCTCCGAGA -> ATCTCCGAGAT
AATCTCTAATG -> ATCTCTAATGC
AATCTGAGATG -> ATCTGAGATGC
AATGCGATGAT -> ATGCGATGATC
AATGCGGGTTC -> ATGCGGGTTCC
AATGGCCGCCT -> ATGGCCGCCTC
AATGGCGGCCG -> ATGGCGGCCGC
AATGGGATAAT -> ATGGGATAATT
AATGGGTCGGG -> ATGGGTCGGGT
AATGGTGCACA -> ATGGTGCACAT
AATGTAAAAAC -> ATGTAAAAACT
AATGTCGGATC -> ATGTCGGATCG
AATGTTTGTTC -> ATGTTTGTTCA
AATTAAAGTTA -> ATTAAAGTTAG
AATTACAATTG -> ATTACAATTGT
AATTACGCCCA -> ATTACGCCCAA
AATTCATGAGC -> ATTCATGAGCG
AATTCTGTGAA -> ATTCTGTGAAA
AATTGATTCCA -> ATTGATTCCAA
AATTGCGTTCG -> ATTGCGTTCGT
AATTGTACCGA -> ATTGTACCGAC
AATTGTTATGT -> ATTGTTATGTA
AATTTAGGGGA -> ATTTAGGGGAA
AATTTTTTCGG -> ATTTTTTCGGA
ACAAGTCGTCC -> CAAGTCGTCCG
ACAATACCGAC -> CAATACCGACC
ACAATGGGATA -> CAATGGGATAA
ACAATTGTTAT -> CAATTGTTATG
ACACATACGGC -> CACATACGGCG
ACACCGCGAAA -> CACCGCGAAAT
ACACTCTTGGT -> CACTCTTGGTG
ACACTGCGCGT -> CACTGCGCGTC
ACAGAACTACA -> CAGAACTACAG
ACAGACAATGG -> CAGACAATGGG
ACAGCGATGGG -> CAGCGATGGGT
ACAGGCCAGCC -> CAGGCCAGCCA
ACAGGTTTTGC -> CAGGTTTTGCA
ACAGTCGCTAT -> CAGTCGCTATC
ACATACGGCGC -> CATACGGCGCC
ACATATGCGAC -> CATATGCGACA
ACATCCATGCC -> CATCCATGCCC
ACATGAGCTCC -> CATGAGCTCCC
ACATGGAGGCA -> CATGGAGGCAG
ACATGGCTCGT -> CATGGCTCGTG
ACATTATGTCG -> CATTATGTCGG
ACATTTTGACG -> CATTTTGACGA
ACCAAAATGTT -> CCAAAATGTTT
ACCAAAGACTC -> CCAAAGACTCT
ACCAACGTCGG -> CCAACGTCGGC
ACCAAGAGCAG -> CCAAGAGCAGG
ACCAATATACC -> CCAATATACCT
ACCACCTCCGA -> CCACCTCCGAC
ACCACTCGCCC -> CCACTCGCCCA
ACCAGTGACTA -> CCAGTGACTAA
ACCATATTCGG -> CCATATTCGGC
ACCCAATAAAT -> CCCAATAAATC
ACCCACGCTGG -> CCCACGCTGGT
ACCCAGGGCAA -> CCCAGGGCAAC
ACCCATATGTA -> CCCATATGTAA
ACCCCCGATAC -> CCCCCGATACG
ACCCCGAGGCC -> CCCCGAGGCCG
ACCCCTTCCAG -> CCCCTTCCAGG
ACCCGCGGCGT -> CCCGCGGCGTT
ACCCGTGTGAC -> CCCGTGTGACC
ACCCTAAAAAA -> CCCTAAAAAAC
ACCCTGAATTT -> CCCTGAATTTA
ACCGACCTCCC -> CCGACCTCCCC
ACCGACGCAAT -> CCGACGCAATC
ACCGCAAGGGC -> CCGCAAGGGCG
ACCGCACCCTA -> CCGCACCCTAA
ACCGCCGCCGG -> CCGCCGCCGGG
ACCGCGAAATC -> CCGCGAAATCG
ACCGCTCCAGT -> CCGCTCCAGTG
ACCGCTGGCAT -> CCGCTGGCATT
ACCGGCCATTT -> CCGGCCATTTG
ACCGGCGTACC -> CCGGCGTACCC
ACCGTAACCAA -> CCGTAACCAAC
ACCTAAACAGA -> CCTAAACAGAC
ACCTACGCCCT -> CCTACGCCCTG
ACCTCACTTAG -> CCTCACTTAGC
ACCTCCCCATT -> CCTCCCCATTT
ACCTCCGACGA -> CCTCCGACGAT
ACCTGATCTTA -> CCTGATCTTAA
ACCTGCTCTTA -> CCTGCTCTTAC
ACCTTAAATGG -> CCTTAAATGGT
ACCTTGCTACC -> CCTTGCTACCC
ACGACATATGC -> CGACATATGCG
ACGACCGCACC -> CGACCGCACCC
ACGACCGTAAC -> CGACCGTAACC
ACGACGTGTAG -> CGACGTGTAGT
ACGACTACGGA -> CGACTACGGAG
ACGACTCCCCC -> CGACTCCCCCG
ACGACTTTGCG -> CGACTTTGCGG
ACGAGTGATTC -> CGAGTGATTCG
ACGATATCGCT -> CGATATCGCTT
ACGATCCCAAG -> CGATCCCAAGC
ACGATTTATTC -> CGATTTATTCA
ACGCAATCCAC -> CGCAATCCACC
ACGCATGACCC -> CGCATGACCCG
ACGCCCAACTA -> CGCCCAACTAA
ACGCCCTGCAT -> CGCCCTGCATT
ACGCGTGCCGA -> CGCGTGCCGAA
ACGCTCCCCAC -> CGCTCCCCACG
ACGCTGGCGGC -> CGCTGGCGGCA
ACGCTGGTCCT -> CGCTGGTCCTT
ACGCTTACGAC -> CGCTTACGACT
ACGGAACCCTG -> CGGAACCCTGA
ACGGAGGCAGA -> CGGAGGCAGAG
ACGGCGCCTCC -> CGGCGCCTCCT
ACGGGCGTCCG -> CGGGCGTCCGC
ACGGTGCCAGC -> CGGTGCCAGCA
ACGGTTCCCGA -> CGGTTCCCGAT
ACGTAATTGAT -> CGTAATTGATT
ACGTAGACCCA -> CGTAGACCCAT
ACGTAGCCGAA -> CGTAGCCGAAG
ACGTCGGCAGA -> CGTCGGCAGAA
ACGTGAAGTCC -> CGTGAAGTCCA
ACGTGTAGTTT -> CGTGTAGTTTG
ACGTTCGACTT -> CGTTCGACTTG
ACGTTTATCGA -> CGTTTATCGAG
ACTAAAGAATG -> CTAAAGAATGG
ACTAACTCAAT -> CTAACTCAATA
ACTAACTTTTC -> CTAACTTTTCG
ACTAATGTAAA -> CTAATGTAAAA
ACTACAGCGAT -> CTACAGCGATG
ACTACGGAGGC -> CTACGGAGGCA
ACTAGGCTAGC -> CTAGGCTAGCG
ACTCAATAGTA -> CTCAATAGTAA
ACTCAGGGGCA -> CTCAGGGGCAT
ACTCCCCCGGA -> CTCCCCCGGAC
ACTCGAGGTGC -> CTCGAGGTGCC
ACTCGCCCAGC -> CTCGCCCAGCG
ACTCTTGGTGT -> CTCTTGGTGTG
ACTCTTGTTGC -> CTCTTGTTGCA
ACTGAAGAGGC -> CTGAAGAGGCG
ACTGCCCATAC -> CTGCCCATACA
ACTGCGAAGTC -> CTGCGAAGTCC
ACTGCGCGTCA -> CTGCGCGTCAC
ACTGTCTAACG -> CTGTCTAACGT
ACTGTGAGGCG -> CTGTGAGGCGT
ACTTAGATGTC -> CTTAGATGTCG
ACTTAGCAATT -> CTTAGCAATTC
ACTTAGGAGTA -> CTTAGGAGTAA
ACTTCGGGGTG -> CTTCGGGGTGT
ACTTCTTTGTT -> CTTCTTTGTTG
ACTTGGTTCCG -> CTTGGTTCCGG
ACTTGTATCCG -> CTTGTATCCGC
ACTTGTCCCGC -> CTTGTCCCGCG
ACTTTGCGGAG -> CTTTGCGGAGG
ACTTTTCGATC -> CTTTTCGATCG
AGAAAATCTAC -> GAAAATCTACA
AGAAACGCTGG -> GAAACGCTGGC
AGAAATTCTGT -> GAAATTCTGTG
AGAACTACAGC -> GAACTACAGCG
AGAAGAGTCAT -> GAAGAGTCATA
AGAATGGCCGC -> GAATGGCCGCC
AGAATGGCGGC -> GAATGGCGGCC
AGAATGTCGGA -> GAATGTCGGAT
AGACAATGGGA -> GACAATGGGAT
AGACATTTTGA -> GACATTTTGAC
AGACCCATATG -> GACCCATATGT
AGACCTCACTT -> GACCTCACTTA
AGACGATTTAT -> GACGATTTATT
AGACTCTTGTT -> GACTCTTGTTG
AGAGAAGAGTC -> GAGAAGAGTCA
AGAGATCGATA -> GAGATCGATAT
AGAGCAGGGAT -> GAGCAGGGATT
AGAGCGTACAC -> GAGCGTACACT
AGAGGAAGCTG -> GAGGAAGCTGG
AGAGGCGTGAC -> GAGGCGTGACG
AGAGTCATAGA -> GAGTCATAGAG
AGATAGCATGA -> GATAGCATGAG
AGATCGATATA -> GATCGATATAC
AGATCGTACCA -> GATCGTACCAC
AGATGACAGGT -> GATGACAGGTT
AGATGCTGATC -> GATGCTGATCG
AGATGGGTATT -> GATGGGTATTT
AGATGTCGCGC -> GATGTCGCGCT
AGCAATTCATG -> GCAATTCATGA
AGCACAGGCCA -> GCACAGGCCAG
AGCACCTGATC -> GCACCTGATCT
AGCAGGGATTT -> GCAGGGATTTC
AGCATGAGTCC -> GCATGAGTCCT
AGCCAAGCTGA -> GCCAAGCTGAC
AGCCAGGACGG -> GCCAGGACGGT
AGCCCGAATTA -> GCCCGAATTAC
AGCCGAAGCCA -> GCCGAAGCCAA
AGCCTTAGGAA -> GCCTTAGGAAA
AGCCTTAGGTT -> GCCTTAGGTTC
AGCGATGGGTT -> GCGATGGGTTC
AGCGATTCCTT -> GCGATTCCTTC
AGCGCCTCCGG -> GCGCCTCCGGT
AGCGCGACGAC -> GCGCGACGACT
AGCGGACGACC -> GCGGACGACCG
AGCGGATGAGT -> GCGGATGAGTC
AGCGTAATATT -> GCGTAATATTC
AGCGTACACTG -> GCGTACACTGC
AGCGTTTGGGG -> GCGTTTGGGGC
AGCTCACTAGG -> GCTCACTAGGC
AGCTCCCGGGA -> GCTCCCGGGAG
AGCTGACTGTG -> GCTGACTGTGA
AGCTGGACGGG -> GCTGGACGGGC
AGCTTATTCGG -> GCTTATTCGGA
AGGAAACCATA -> GGAAACCATAT
AGGAAGCTGGA -> GGAAGCTGGAC
AGGAATATAAT -> GGAATATAATA
AGGAATTTTTT -> GGAATTTTTTC
AGGACGCGTGC -> GGACGCGTGCC
AGGACGGTGCC -> GGACGGTGCCA
AGGAGGCAGAA -> GGAGGCAGAAA
AGGAGTAACCG -> GGAGTAACCGC
AGGATGATTTG -> GGATGATTTGA
AGGATTTAAGT -> GGATTTAAGTA
AGGCAGAAAAT -> GGCAGAAAATC
AGGCAGAAATT -> GGCAGAAATTC
AGGCAGAGAAG -> GGCAGAGAAGA
AGGCCAGCCAG -> GGCCAGCCAGG
AGGCCGCCTGC -> GGCCGCCTGCG
AGGCGTGACGA -> GGCGTGACGAC
AGGCGTGACTC -> GGCGTGACTCG
AGGCTAGCGGA -> GGCTAGCGGAC
AGGGATTTCGC -> GGGATTTCGCG
AGGGCAAATAC -> GGGCAAATACC
AGGGCAACTGC -> GGGCAACTGCC
AGGGCAGTGGT -> GGGCAGTGGTG
AGGGCGTGACC -> GGGCGTGACCT
AGGGGAATTGC -> GGGGAATTGCG
AGGGGCAGATA -> GGGGCAGATAG
AGGGGCATTAG -> GGGGCATTAGT
AGGGTGCACGT -> GGGTGCACGTT
AGGTCCGACGG -> GGTCCGACGGA
AGGTGCCAAGG -> GGTGCCAAGGA
AGGTTCCCTGT -> GGTTCCCTGTT
AGGTTTTAGGG -> GGTTTTAGGGG
AGGTTTTGCAA -> GGTTTTGCAAC
AGTAACCGCTG -> GTAACCGCTGG
AGTAAGGATGA -> GTAAGGATGAT
AGTATCACGTA -> GTATCACGTAG
AGTATCCCGTT -> GTATCCCGTTA
AGTATCCTGCA -> GTATCCTGCAA
AGTCAAGATGG -> GTCAAGATGGG
AGTCAGTCAAG -> GTCAGTCAAGA
AGTCATACGTG -> GTCATACGTGA
AGTCATAGAGC -> GTCATAGAGCG
AGTCCACCGCA -> GTCCACCGCAA
AGTCCATACGC -> GTCCATACGCT
AGTCCGCTCGA -> GTCCGCTCGAA
AGTCCTGTGGG -> GTCCTGTGGGA
AGTCGCTATCC -> GTCGCTATCCT
AGTCGTCCGTT -> GTCGTCCGTTG
AGTGAAGTGGT -> GTGAAGTGGTG
AGTGACCACTC -> GTGACCACTCG
AGTGACTAATG -> GTGACTAATGT
AGTGATTCGGT -> GTGATTCGGTC
AGTGGTGACCC -> GTGGTGACCCC
AGTGGTGCTAC -> GTGGTGCTACA
AGTTAGAATGG -> GTTAGAATGGC
AGTTAGACCTC -> GTTAGACCTCA
AGTTGCTCGGC -> GTTGCTCGGCT
AGTTTGCGCTT -> GTTTGCGCTTA
ATAAATCTGAG -> TAAATCTGAGA
ATAACGAGTGA -> TAACGAGTGAT
ATAATAGGGTG -> TAATAGGGTGC
ATAATTAAAGT -> TAATTAAAGTT
ATACACCGCGA -> TACACCGCGAA
ATACATGGAGG -> TACATGGAGGC
ATACCAAAGAC -> TACCAAAGACT
ATACCGACCTC -> TACCGACCTCC
ATACCGGCCAT -> TACCGGCCATT
ATACCTAAACA -> TACCTAAACAG
ATACGACCGCA -> TACGACCGCAC
ATACGCTCCCC -> TACGCTCCCCA
ATACGGCGCCT -> TACGGCGCCTC
ATACGTGAAGT -> TACGTGAAGTC
ATAGAGCGTAC -> TAGAGCGTACA
ATAGCATGAGT -> TAGCATGAGTC
ATAGGGTGCAC -> TAGGGTGCACG
ATAGTAAGGAT -> TAGTAAGGATG
ATAGTGAAGTG -> TAGTGAAGTGG
ATATAATAGGG -> TATAATAGGGT
ATATACCAAAG -> TATACCAAAGA
ATATACCTAAA -> TATACCTAAAC
ATATCGCTTTT -> TATCGCTTTTT
ATATGCGACAC -> TATGCGACACA
ATATGTAATCT -> TATGTAATCTC
ATATTCGGCAG -> TATTCGGCAGC
ATATTCGTGCG -> TATTCGTGCGG
ATCACGTAGCC -> TCACGTAGCCG
ATCCACCGCCG -> TCCACCGCCGC
ATCCATGCCCA -> TCCATGCCCAT
ATCCCAAGCCT -> TCCCAAGCCTT
ATCCCGTTATG -> TCCCGTTATGT
ATCCGCGAGCC -> TCCGCGAGCCT
ATCCTAGAATG -> TCCTAGAATGT
ATCCTGACTGT -> TCCTGACTGTC
ATCCTGCAAAC -> TCCTGCAAACT
ATCGACCAAGA -> TCGACCAAGAG
ATCGAGTCTCG -> TCGAGTCTCGC
ATCGATATACC -> TCGATATACCA
ATCGCTTTTTG -> TCGCTTTTTGA
ATCGGCTCCCG -> TCGGCTCCCGT
ATCGGCTGAGT -> TCGGCTGAGTC
ATCGGTAATTA -> TCGGTAATTAC
ATCGGTGAAGG -> TCGGTGAAGGT
ATCGTACCACC -> TCGTACCACCT
ATCGTACTAAC -> TCGTACTAACT
ATCTACAATAC -> TCTACAATACC
ATCTCCGAGAT -> TCTCCGAGATC
ATCTCTAATGC -> TCTCTAATGCG
ATCTGAGATGC -> TCTGAGATGCT
ATCTGTGCGGA -> TCTGTGCGGAC
ATCTTAAATCT -> TCTTAAATCTC
ATGAATTGTAC -> TGAATTGTACC
ATGACAGGTTT -> TGACAGGTTTT
ATGACCCGCGG -> TGACCCGCGGC
ATGACCGGCGT -> TGACCGGCGTA
ATGAGCGTTTG -> TGAGCGTTTGG
ATGAGCTCCCG -> TGAGCTCCCGG
ATGAGTCCACC -> TGAGTCCACCG
ATGAGTCCTGT -> TGAGTCCTGTG
ATGATCGGCTG -> TGATCGGCTGA
ATGATTTGACT -> TGATTTGACTC
ATGCCCATTCG -> TGCCCATTCGA
ATGCGACACAT -> TGCGACACATA
ATGCGATGATC -> TGCGATGATCG
ATGCGGGTTCC -> TGCGGGTTCCA
ATGCTGACTGA -> TGCTGACTGAA
ATGCTGATCGG -> TGCTGATCGGT
ATGGAGCGATT -> TGGAGCGATTC
ATGGAGGCAGA -> TGGAGGCAGAA
ATGGCAGGATT -> TGGCAGGATTT
ATGGCCGCCTC -> TGGCCGCCTCA
ATGGCGGCCGC -> TGGCGGCCGCG
ATGGCTCGTGT -> TGGCTCGTGTA
ATGGGATAATT -> TGGGATAATTA
ATGGGTATTTA -> TGGGTATTTAC
ATGGGTCGGGT -> TGGGTCGGGTG
ATGGGTTCCAT -> TGGGTTCCATA
ATGGTGCACAT -> TGGTGCACATG
ATGTAAAAACT -> TGTAAAAACTT
ATGTAATCTCT -> TGTAATCTCTA
ATGTAGTTGCT -> TGTAGTTGCTC
ATGTCGCGCTG -> TGTCGCGCTGA
ATGTCGGAGAG -> TGTCGGAGAGA
ATGTCGGATCG -> TGTCGGATCGA
ATGTTACCAGT -> TGTTACCAGTG
ATGTTTGTTCA -> TGTTTGTTCAA
ATTAAAATGGG -> TTAAAATGGGT
ATTAAAGTTAG -> TTAAAGTTAGA
ATTACAATTGT -> TTACAATTGTT
ATTACGCATGA -> TTACGCATGAC
ATTACGCCCAA -> TTACGCCCAAC
ATTAGCCCGAA -> TTAGCCCGAAT
ATTAGTATCCC -> TTAGTATCCCG
ATTATGTCGGA -> TTATGTCGGAG
ATTATTGGGAA -> TTATTGGGAAA
ATTCAGCTCAC -> TTCAGCTCACT
ATTCATGAGCG -> TTCATGAGCGT
ATTCCAAGGTC -> TTCCAAGGTCC
ATTCCTTCAAA -> TTCCTTCAAAG
ATTCGAAACTT -> TTCGAAACTTG
ATTCGAGGGCA -> TTCGAGGGCAA
ATTCGGATTAT -> TTCGGATTATT
ATTCGGCAGCT -> TTCGGCAGCTT
ATTCGGTCGCC -> TTCGGTCGCCT
ATTCGTGCGGC -> TTCGTGCGGCT
ATTCTGTGAAA -> TTCTGTGAAAG
ATTGATTCCAA -> TTGATTCCAAG
ATTGCGTTCGT -> TTGCGTTCGTC
ATTGCGTTGAA -> TTGCGTTGAAA
ATTGGGAAAGA -> TTGGGAAAGAC
ATTGTACCGAC -> TTGTACCGACG
ATTGTTATGTA -> TTGTTATGTAG
ATTTAAGTATC -> TTTAAGTATCA
ATTTACATGGC -> TTTACATGGCT
ATTTAGGGGAA -> TTTAGGGGAAT
ATTTATTAGCC -> TTTATTAGCCC
ATTTATTCAGC -> TTTATTCAGCT
ATTTCGCGTGG -> TTTCGCGTGGA
ATTTGACGTTT -> TTTGACGTTTA
ATTTGACTCAG -> TTTGACTCAGG
ATTTGATGGAG -> TTTGATGGAGC
ATTTTGACGAT -> TTTTGACGATC
ATTTTTTCGGA -> TTTTTTCGGAA
CAAAAATCCTG -> AAAAATCCTGA
CAAAATGTTTG -> AAAATGTTTGT
CAAACTAAAGA -> AAACTAAAGAA
CAAAGACTCTT -> AAAGACTCTTG
CAAAGGAATTT -> AAAGGAATTTT
CAAATACCGGC -> AAATACCGGCC
CAACATTATGT -> AACATTATGTC
CAACCAATATA -> AACCAATATAC
CAACGTAATTG -> AACGTAATTGA
CAACGTCGGCA -> AACGTCGGCAG
CAACTAACTTT -> AACTAACTTTT
CAACTGCCCAT -> AACTGCCCATA
CAAGACATTTT -> AAGACATTTTG
CAAGAGCAGGG -> AAGAGCAGGGA
CAAGATGGGTA -> AAGATGGGTAT
CAAGCCTTAGG -> AAGCCTTAGGT
CAAGCTGACTG -> AAGCTGACTGT
CAAGGAGGCAG -> AAGGAGGCAGA
CAAGGGCAGTG -> AAGGGCAGTGG
CAAGGGCGTGA -> AAGGGCGTGAC
CAAGGTCCGAC -> AAGGTCCGACG
CAAGTCGTCCG -> AAGTCGTCCGT
CAAGTTAGAAT -> AAGTTAGAATG
CAATAAATCTG -> AATAAATCTGA
CAATACCGACC -> AATACCGACCT
CAATAGTAAGG -> AATAGTAAGGA
CAATATACCTA -> AATATACCTAA
CAATCCACCGC -> AATCCACCGCC
CAATCGGTGAA -> AATCGGTGAAG
CAATGGGATAA -> AATGGGATAAT
CAATTCATGAG -> AATTCATGAGC
CAATTGTTATG -> AATTGTTATGT
CACAGGCCAGC -> ACAGGCCAGCC
CACAGTCGCTA -> ACAGTCGCTAT
CACATACGGCG -> ACATACGGCGC
CACATGAGCTC -> ACATGAGCTCC
CACCCGTGTGA -> ACCCGTGTGAC
CACCCTAAAAA -> ACCCTAAAAAA
CACCGCAAGGG -> ACCGCAAGGGC
CACCGCCGCCG -> ACCGCCGCCGG
CACCGCGAAAT -> ACCGCGAAATC
CACCTCCGACG -> ACCTCCGACGA
CACCTGATCTT -> ACCTGATCTTA
CACGCTGGTCC -> ACGCTGGTCCT
CACGGTTCCCG -> ACGGTTCCCGA
CACGTAGCCGA -> ACGTAGCCGAA
CACGTTCGACT -> ACGTTCGACTT
CACTAGGCTAG -> ACTAGGCTAGC
CACTCGCCCAG -> ACTCGCCCAGC
CACTCTTGGTG -> ACTCTTGGTGT
CACTGCGAAGT -> ACTGCGAAGTC
CACTGCGCGTC -> ACTGCGCGTCA
CACTTAGCAAT -> ACTTAGCAATT
CAGAAAATCTA -> AGAAAATCTAC
CAGAAACGCTG -> AGAAACGCTGG
CAGAAATTCTG -> AGAAATTCTGT
CAGAACTACAG -> AGAACTACAGC
CAGACAATGGG -> AGACAATGGGA
CAGAGAAGAGT -> AGAGAAGAGTC
CAGAGGAAGCT -> AGAGGAAGCTG
CAGATAGCATG -> AGATAGCATGA
CAGCACCTGAT -> AGCACCTGATC
CAGCCAGGACG -> AGCCAGGACGG
CAGCGATGGGT -> AGCGATGGGTT
CAGCGGATGAG -> AGCGGATGAGT
CAGCGTAATAT -> AGCGTAATATT
CAGCTCACTAG -> AGCTCACTAGG
CAGCTTATTCG -> AGCTTATTCGG
CAGGAATATAA -> AGGAATATAAT
CAGGACGGTGC -> AGGACGGTGCC
CAGGATTTAAG -> AGGATTTAAGT
CAGGCCAGCCA -> AGGCCAGCCAG
CAGGGATTTCG -> AGGGATTTCGC
CAGGGCAACTG -> AGGGCAACTGC
CAGGGGCATTA -> AGGGGCATTAG
CAGGTTTTGCA -> AGGTTTTGCAA
CAGTCAAGATG -> AGTCAAGATGG
CAGTCGCTATC -> AGTCGCTATCC
CAGTGACCACT -> AGTGACCACTC
CAGTGACTAAT -> AGTGACTAATG
CAGTGGTGACC -> AGTGGTGACCC
CATAACGAGTG -> ATAACGAGTGA
CATACACCGCG -> ATACACCGCGA
CATACGCTCCC -> ATACGCTCCCC
CATACGGCGCC -> ATACGGCGCCT
CATACGTGAAG -> ATACGTGAAGT
CATAGAGCGTA -> ATAGAGCGTAC
CATATGCGACA -> ATATGCGACAC
CATATGTAATC -> ATATGTAATCT
CATATTCGGCA -> ATATTCGGCAG
CATCCATGCCC -> ATCCATGCCCA
CATCTGTGCGG -> ATCTGTGCGGA
CATGAATTGTA -> ATGAATTGTAC
CATGACCCGCG -> ATGACCCGCGG
CATGAGCGTTT -> ATGAGCGTTTG
CATGAGCTCCC -> ATGAGCTCCCG
CATGAGTCCTG -> ATGAGTCCTGT
CATGCCCATTC -> ATGCCCATTCG
CATGGAGGCAG -> ATGGAGGCAGA
CATGGCTCGTG -> ATGGCTCGTGT
CATTAAAATGG -> ATTAAAATGGG
CATTAGTATCC -> ATTAGTATCCC
CATTATGTCGG -> ATTATGTCGGA
CATTCGAAACT -> ATTCGAAACTT
CATTGCGTTGA -> ATTGCGTTGAA
CATTTATTAGC -> ATTTATTAGCC
CATTTGATGGA -> ATTTGATGGAG
CATTTTGACGA -> ATTTTGACGAT
CCAAAATGTTT -> CAAAATGTTTG
CCAAAGACTCT -> CAAAGACTCTT
CCAACGTCGGC -> CAACGTCGGCA
CCAACTAACTT -> CAACTAACTTT
CCAAGAGCAGG -> CAAGAGCAGGG
CCAAGCCTTAG -> CAAGCCTTAGG
CCAAGCTGACT -> CAAGCTGACTG
CCAAGGAGGCA -> CAAGGAGGCAG
CCAAGGGCAGT -> CAAGGGCAGTG
CCAAGGTCCGA -> CAAGGTCCGAC
CCAATAAATCT -> CAATAAATCTG
CCAATATACCT -> CAATATACCTA
CCACCGCAAGG -> CACCGCAAGGG
CCACCGCCGCC -> CACCGCCGCCG
CCACCTCCGAC -> CACCTCCGACG
CCACGCTGGTC -> CACGCTGGTCC
CCACGGTTCCC -> CACGGTTCCCG
CCACTCGCCCA -> CACTCGCCCAG
CCAGCACCTGA -> CAGCACCTGAT
CCAGCCAGGAC -> CAGCCAGGACG
CCAGCGGATGA -> CAGCGGATGAG
CCAGCGTAATA -> CAGCGTAATAT
CCAGGAATATA -> CAGGAATATAA
CCAGGACGGTG -> CAGGACGGTGC
CCAGGGCAACT -> CAGGGCAACTG
CCAGTGACCAC -> CAGTGACCACT
CCAGTGACTAA -> CAGTGACTAAT
CCATAACGAGT -> CATAACGAGTG
CCATACACCGC -> CATACACCGCG
CCATACGCTCC -> CATACGCTCCC
CCATATGTAAT -> CATATGTAATC
CCATATTCGGC -> CATATTCGGCA
CCATGCCCATT -> CATGCCCATTC
CCATTCGAAAC -> CATTCGAAACT
CCATTTATTAG -> CATTTATTAGC
CCATTTGATGG -> CATTTGATGGA
CCCAACTAACT -> CCAACTAACTT
CCCAAGCCTTA -> CCAAGCCTTAG
CCCAATAAATC -> CCAATAAATCT
CCCACGCTGGT -> CCACGCTGGTC
CCCACGGTTCC -> CCACGGTTCCC
CCCAGCGGATG -> CCAGCGGATGA
CCCAGGGCAAC -> CCAGGGCAACT
CCCATACACCG -> CCATACACCGC
CCCATATGTAA -> CCATATGTAAT
CCCATTCGAAA -> CCATTCGAAAC
CCCATTTATTA -> CCATTTATTAG
CCCCACGGTTC -> CCCACGGTTCC
CCCCATTTATT -> CCCATTTATTA
CCCCCGATACG -> CCCCGATACGA
CCCCCGGACCC -> CCCCGGACCCA
CCCCGAGGCCG -> CCCGAGGCCGC
CCCCGATACGA -> CCCGATACGAC
CCCCGGACCCA -> CCCGGACCCAG
CCCCTTCCAGG -> CCCTTCCAGGA
CCCGAATTACA -> CCGAATTACAA
CCCGAGGCCGC -> CCGAGGCCGCC
CCCGATACGAC -> CCGATACGACC
CCCGATGACCG -> CCGATGACCGG
CCCGCGGCGTT -> CCGCGGCGTTC
CCCGCGGTGGA -> CCGCGGTGGAT
CCCGGACCCAG -> CCGGACCCAGG
CCCGGGAGCAC -> CCGGGAGCACA
CCCGTCGCACA -> CCGTCGCACAG
CCCGTGACAGA -> CCGTGACAGAA
CCCGTGTGACC -> CCGTGTGACCT
CCCGTTATGTT -> CCGTTATGTTA
CCCTAAAAAAC -> CCTAAAAAACC
CCCTGAATTTA -> CCTGAATTTAG
CCCTGCATTAA -> CCTGCATTAAA
CCCTGTTCAAG -> CCTGTTCAAGT
CCCTTCCAGGA -> CCTTCCAGGAA
CCGAAGCCAAG -> CGAAGCCAAGC
CCGAATAGTGA -> CGAATAGTGAA
CCGAATTACAA -> CGAATTACAAT
CCGACCTCCCC -> CGACCTCCCCA
CCGACGATATC -> CGACGATATCG
CCGACGCAATC -> CGACGCAATCC
CCGACGGAACC -> CGACGGAACCC
CCGAGATCGTA -> CGAGATCGTAC
CCGAGGCCGCC -> CGAGGCCGCCT
CCGATACGACC -> CGATACGACCG
CCGATGACCGG -> CGATGACCGGC
CCGCAAGGGCG -> CGCAAGGGCGT
CCGCACCCTAA -> CGCACCCTAAA
CCGCCGCCGGG -> CGCCGCCGGGT
CCGCCGGGTGT -> CGCCGGGTGTC
CCGCCTCACTG -> CGCCTCACTGC
CCGCCTGCGAA -> CGCCTGCGAAC
CCGCGAAATCG -> CGCGAAATCGT
CCGCGAGCCTT -> CGCGAGCCTTA
CCGCGCATGAA -> CGCGCATGAAT
CCGCGGAATAC -> CGCGGAATACA
CCGCGGCGTTC -> CGCGGCGTTCT
CCGCGGTGGAT -> CGCGGTGGATT
CCGCTCCAGTG -> CGCTCCAGTGA
CCGCTCGAACG -> CGCTCGAACGC
CCGCTGGCATT -> CGCTGGCATTG
CCGGACCCAGG -> CGGACCCAGGG
CCGGCAACATT -> CGGCAACATTA
CCGGCCATTTG -> CGGCCATTTGA
CCGGCGTACCC -> CGGCGTACCCA
CCGGGAGCACA -> CGGGAGCACAG
CCGGGTGTCGA -> CGGGTGTCGAC
CCGGTCAACGT -> CGGTCAACGTA
CCGTAACCAAC -> CGTAACCAACG
CCGTCGCACAG -> CGTCGCACAGT
CCGTGACAGAA -> CGTGACAGAAC
CCGTGTGACCT -> CGTGTGACCTT
CCGTTATGTTA -> CGTTATGTTAC
CCGTTGCAGAG -> CGTTGCAGAGG
CCTAAAAAACC -> CTAAAAAACCT
CCTAAACAGAC -> CTAAACAGACA
CCTAATGCGAT -> CTAATGCGATG
CCTACGCCCTG -> CTACGCCCTGC
CCTACTTAGGA -> CTACTTAGGAG
CCTAGAATGTC -> CTAGAATGTCG
CCTCACTGCGA -> CTCACTGCGAA
CCTCACTTAGC -> CTCACTTAGCA
CCTCCCCATTT -> CTCCCCATTTA
CCTCCGACGAT -> CTCCGACGATA
CCTCCGGTCAA -> CTCCGGTCAAC
CCTCCTTGCTA -> CTCCTTGCTAA
CCTGAATTTAG -> CTGAATTTAGG
CCTGACGACTC -> CTGACGACTCC
CCTGACTGTCT -> CTGACTGTCTA
CCTGATCTTAA -> CTGATCTTAAA
CCTGCAAACTA -> CTGCAAACTAA
CCTGCATTAAA -> CTGCATTAAAA
CCTGCGAACCC -> CTGCGAACCCA
CCTGCTCTTAC -> CTGCTCTTACC
CCTGTGGGATG -> CTGTGGGATGG
CCTGTTCAAGT -> CTGTTCAAGTT
CCTTAAATGGT -> CTTAAATGGTG
CCTTAACGACA -> CTTAACGACAT
CCTTAGGAAAC -> CTTAGGAAACC
CCTTAGGTTCC -> CTTAGGTTCCC
CCTTCAAAGGA -> CTTCAAAGGAA
CCTTCCAGGAA -> CTTCCAGGAAT
CCTTGCTAAAG -> CTTGCTAAAGT
CCTTGCTACCC -> CTTGCTACCCC
CGAAACTTGTC -> GAAACTTGTCC
CGAAATCGTAC -> GAAATCGTACT
CGAACCCAATA -> GAACCCAATAA
CGAACGCTTAC -> GAACGCTTACG
CGAAGCCAAGC -> GAAGCCAAGCT
CGAAGTCCGCT -> GAAGTCCGCTC
CGAATAGTGAA -> GAATAGTGAAG
CGAATTACAAT -> GAATTACAATT
CGACACATACG -> GACACATACGG
CGACATATGCG -> GACATATGCGA
CGACCAAGAGC -> GACCAAGAGCA
CGACCGCACCC -> GACCGCACCCT
CGACCGTAACC -> GACCGTAACCA
CGACCTCCCCA -> GACCTCCCCAT
CGACGACTTTG -> GACGACTTTGC
CGACGATATCG -> GACGATATCGC
CGACGCAATCC -> GACGCAATCCA
CGACGGAACCC -> GACGGAACCCT
CGACGTGTAGT -> GACGTGTAGTT
CGACTACGGAG -> GACTACGGAGG
CGACTCCCCCG -> GACTCCCCCGG
CGACTTCTTTG -> GACTTCTTTGT
CGACTTGTATC -> GACTTGTATCC
CGACTTTGCGG -> GACTTTGCGGA
CGAGATCGTAC -> GAGATCGTACC
CGAGCCTTAGG -> GAGCCTTAGGA
CGAGGCCGCCT -> GAGGCCGCCTG
CGAGGGCAAAT -> GAGGGCAAATA
CGAGGTGCCAA -> GAGGTGCCAAG
CGAGTGATTCG -> GAGTGATTCGG
CGATACGACCG -> GATACGACCGC
CGATATACCAA -> GATATACCAAA
CGATATCGCTT -> GATATCGCTTT
CGATCCCAAGC -> GATCCCAAGCC
CGATCGGCTCC -> GATCGGCTCCC
CGATGACCGGC -> GATGACCGGCG
CGATGATCGGC -> GATGATCGGCT
CGATGGGTTCC -> GATGGGTTCCA
CGATTCCTTCA -> GATTCCTTCAA
CGATTCGAGGG -> GATTCGAGGGC
CGATTTATTCA -> GATTTATTCAG
CGCAAAAATCC -> GCAAAAATCCT
CGCAAGGGCGT -> GCAAGGGCGTG
CGCAATCCACC -> GCAATCCACCG
CGCACAGTCGC -> GCACAGTCGCT
CGCACCCTAAA -> GCACCCTAAAA
CGCATGAATTG -> GCATGAATTGT
CGCATGACCCG -> GCATGACCCGC
CGCCCAACTAA -> GCCCAACTAAC
CGCCCAGCGGA -> GCCCAGCGGAT
CGCCCTGCATT -> GCCCTGCATTA
CGCCGCCGGGT -> GCCGCCGGGTG
CGCCGGGTGTC -> GCCGGGTGTCG
CGCCTACTTAG -> GCCTACTTAGG
CGCCTCACTGC -> GCCTCACTGCG
CGCCTCCGGTC -> GCCTCCGGTCA
CGCCTCCTTGC -> GCCTCCTTGCT
CGCCTGCGAAC -> GCCTGCGAACC
CGCGAAATCGT -> GCGAAATCGTA
CGCGACGACTT -> GCGACGACTTT
CGCGAGCCTTA -> GCGAGCCTTAG
CGCGCATGAAT -> GCGCATGAATT
CGCGCTGATGC -> GCGCTGATGCT
CGCGGAATACA -> GCGGAATACAT
CGCGGCGTTCT -> GCGGCGTTCTT
CGCGGTGGATT -> GCGGTGGATTT
CGCGTCACCCG -> GCGTCACCCGT
CGCGTGCCGAA -> GCGTGCCGAAT
CGCGTGGAACC -> GCGTGGAACCT
CGCTATCCTAG -> GCTATCCTAGA
CGCTCCAGTGA -> GCTCCAGTGAC
CGCTCCCCACG -> GCTCCCCACGG
CGCTCGAACGC -> GCTCGAACGCT
CGCTGATGCTG -> GCTGATGCTGA
CGCTGGCATTG -> GCTGGCATTGC
CGCTGGCGGCA -> GCTGGCGGCAA
CGCTGGTCCTT -> GCTGGTCCTTA
CGCTTACGACT -> GCTTACGACTA
CGCTTAGATGA -> GCTTAGATGAC
CGCTTTTTGAT -> GCTTTTTGATT
CGGAACCCCTT -> GGAACCCCTTC
CGGAACCCTGA -> GGAACCCTGAA
CGGAATACATG -> GGAATACATGG
CGGACATCCAT -> GGACATCCATG
CGGACCCAGGG -> GGACCCAGGGC
CGGACGACCGT -> GGACGACCGTA
CGGAGAGATCG -> GGAGAGATCGA
CGGAGGACGCG -> GGAGGACGCGT
CGGAGGCAGAG -> GGAGGCAGAGA
CGGATCGACCA -> GGATCGACCAA
CGGATGAGTCC -> GGATGAGTCCA
CGGATTATTGG -> GGATTATTGGG
CGGCAACATTA -> GGCAACATTAT
CGGCAAGACAT -> GGCAAGACATT
CGGCAGAAACG -> GGCAGAAACGC
CGGCAGCTTAT -> GGCAGCTTATT
CGGCCATTTGA -> GGCCATTTGAT
CGGCCGCGGAA -> GGCCGCGGAAT
CGGCGCCTCCT -> GGCGCCTCCTT
CGGCGTACCCA -> GGCGTACCCAC
CGGCGTTCTTC -> GGCGTTCTTCG
CGGCTCCAAGG -> GGCTCCAAGGG
CGGCTCCCGTC -> GGCTCCCGTCG
CGGCTCTCCTA -> GGCTCTCCTAA
CGGCTCTTGAG -> GGCTCTTGAGC
CGGCTGAGTCA -> GGCTGAGTCAG
CGGGAGCACAG -> GGGAGCACAGG
CGGGCGTCCGC -> GGGCGTCCGCG
CGGGGTGTTCC -> GGGGTGTTCCT
CGGGTGTCGAC -> GGGTGTCGACT
CGGGTGTTTTC -> GGGTGTTTTCC
CGGGTTCCAGC -> GGGTTCCAGCG
CGGTAATTACG -> GGTAATTACGC
CGGTCAACGTA -> GGTCAACGTAA
CGGTCGCCTAC -> GGTCGCCTACT
CGGTGAAGGTT -> GGTGAAGGTTT
CGGTGCCAGCA -> GGTGCCAGCAC
CGGTGGATTTG -> GGTGGATTTGA
CGGTTCCCGAT -> GGTTCCCGATG
CGTAACCAACG -> GTAACCAACGT
CGTAATATTCG -> GTAATATTCGT
CGTAATTGATT -> GTAATTGATTC
CGTACACTGCG -> GTACACTGCGC
CGTACCACCTC -> GTACCACCTCC
CGTACCCACGC -> GTACCCACGCT
CGTACTAACTC -> GTACTAACTCA
CGTAGACCCAT -> GTAGACCCATA
CGTAGCCGAAG -> GTAGCCGAAGC
CGTCACCCGTG -> GTCACCCGTGT
CGTCCGCGCAT -> GTCCGCGCATG
CGTCCGTTGCA -> GTCCGTTGCAG
CGTCGCACAGT -> GTCGCACAGTC
CGTCGGCAGAA -> GTCGGCAGAAA
CGTCTACCAAA -> GTCTACCAAAA
CGTGAAGTCCA -> GTGAAGTCCAT
CGTGACAGAAC -> GTGACAGAACT
CGTGACCTACG -> GTGACCTACGC
CGTGACGACGT -> GTGACGACGTG
CGTGACTCGAG -> GTGACTCGAGG
CGTGCCGAATA -> GTGCCGAATAG
CGTGCGGCTCT -> GTGCGGCTCTT
CGTGGAACCTG -> GTGGAACCTGC
CGTGTAACAAG -> GTGTAACAAGT
CGTGTAGTTTG -> GTGTAGTTTGC
CGTGTGACCTT -> GTGTGACCTTA
CGTTATGTTAC -> GTTATGTTACC
CGTTCGACTTG -> GTTCGACTTGT
CGTTCGTCTAC -> GTTCGTCTACC
CGTTCTTCGCA -> GTTCTTCGCAA
CGTTGAAACTT -> GTTGAAACTTC
CGTTGCAGAGG -> GTTGCAGAGGA
CGTTTATCGAG -> GTTTATCGAGT
CGTTTGGGGCT -> GTTTGGGGCTT
CTAAAAAACCT -> TAAAAAACCTT
CTAAACAGACA -> TAAACAGACAA
CTAAAGAATGG -> TAAAGAATGGC
CTAAAGTATCC -> TAAAGTATCCT
CTAACGTAGAC -> TAACGTAGACC
CTAACTCAATA -> TAACTCAATAG
CTAACTTTTCG -> TAACTTTTCGA
CTAATGCGATG -> TAATGCGATGA
CTAATGCGGGT -> TAATGCGGGTT
CTAATGTAAAA -> TAATGTAAAAA
CTACAATACCG -> TACAATACCGA
CTACACTCTTG -> TACACTCTTGG
CTACAGCGATG -> TACAGCGATGG
CTACCAAAATG -> TACCAAAATGT
CTACCCCGAGG -> TACCCCGAGGC
CTACGCCCTGC -> TACGCCCTGCA
CTACGGAGGCA -> TACGGAGGCAG
CTACTTAGGAG -> TACTTAGGAGT
CTAGAATGTCG -> TAGAATGTCGG
CTAGCGGACGA -> TAGCGGACGAC
CTAGGCTAGCG -> TAGGCTAGCGG
CTATCCTAGAA -> TATCCTAGAAT
CTCAATAGTAA -> TCAATAGTAAG
CTCACTAGGCT -> TCACTAGGCTA
CTCACTGCGAA -> TCACTGCGAAG
CTCACTTAGCA -> TCACTTAGCAA
CTCAGGGGCAT -> TCAGGGGCATT
CTCCAAGGGCA -> TCCAAGGGCAG
CTCCAGTGACC -> TCCAGTGACCA
CTCCCCACGGT -> TCCCCACGGTT
CTCCCCATTTA -> TCCCCATTTAT
CTCCCCCGGAC -> TCCCCCGGACC
CTCCCGGGAGC -> TCCCGGGAGCA
CTCCCGTCGCA -> TCCCGTCGCAC
CTCCGACGATA -> TCCGACGATAT
CTCCGAGATCG -> TCCGAGATCGT
CTCCGGTCAAC -> TCCGGTCAACG
CTCCTAATGCG -> TCCTAATGCGA
CTCCTTGCTAA -> TCCTTGCTAAA
CTCGAACGCTT -> TCGAACGCTTA
CTCGAGGTGCC -> TCGAGGTGCCA
CTCGCCCAGCG -> TCGCCCAGCGG
CTCGGCTCCAA -> TCGGCTCCAAG
CTCGTGTAACA -> TCGTGTAACAA
CTCTAATGCGG -> TCTAATGCGGG
CTCTCCTAATG -> TCTCCTAATGC
CTCTTACCGCT -> TCTTACCGCTC
CTCTTGAGCGC -> TCTTGAGCGCG
CTCTTGGTGTG -> TCTTGGTGTGT
CTCTTGTTGCA -> TCTTGTTGCAT
CTGAAGAGGCG -> TGAAGAGGCGT
CTGAATTTAGG -> TGAATTTAGGG
CTGACGACTCC -> TGACGACTCCC
CTGACTGAAGA -> TGACTGAAGAG
CTGACTGTCTA -> TGACTGTCTAA
CTGACTGTGAG -> TGACTGTGAGG
CTGAGATGCTG -> TGAGATGCTGA
CTGAGTCAGTC -> TGAGTCAGTCA
CTGATCGGTAA -> TGATCGGTAAT
CTGATCTTAAA -> TGATCTTAAAT
CTGATGCTGAC -> TGATGCTGACT
CTGCAAACTAA -> TGCAAACTAAA
CTGCATTAAAA -> TGCATTAAAAT
CTGCCCATACA -> TGCCCATACAC
CTGCGAACCCA -> TGCGAACCCAA
CTGCGAAGTCC -> TGCGAAGTCCG
CTGCGCGTCAC -> TGCGCGTCACC
CTGCTCTTACC -> TGCTCTTACCG
CTGGACGGGCG -> TGGACGGGCGT
CTGGCATTGCG -> TGGCATTGCGT
CTGGCGGCAAG -> TGGCGGCAAGA
CTGGTCCTTAA -> TGGTCCTTAAC
CTGTCTAACGT -> TGTCTAACGTA
CTGTGAAAGTC -> TGTGAAAGTCA
CTGTGAGGCGT -> TGTGAGGCGTG
CTGTGCGGACA -> TGTGCGGACAT
CTGTGGGATGG -> TGTGGGATGGC
CTGTTCAAGTT -> TGTTCAAGTTA
CTTAAATCTCC -> TTAAATCTCCG
CTTAAATGGTG -> TTAAATGGTGC
CTTAACGACAT -> TTAACGACATA
CTTACCGCTCC -> TTACCGCTCCA
CTTACGACTAC -> TTACGACTACG
CTTAGATGACA -> TTAGATGACAG
CTTAGATGTCG -> TTAGATGTCGC
CTTAGCAATTC -> TTAGCAATTCA
CTTAGCGCCTC -> TTAGCGCCTCC
CTTAGGAAACC -> TTAGGAAACCA
CTTAGGAGTAA -> TTAGGAGTAAC
CTTAGGTTCCC -> TTAGGTTCCCT
CTTATTCGGAT -> TTATTCGGATT
CTTCAAAGGAA -> TTCAAAGGAAT
CTTCCAGGAAT -> TTCCAGGAATA
CTTCGCAAAAA -> TTCGCAAAAAT
CTTCGGGGTGT -> TTCGGGGTGTT
CTTCTTAGCGC -> TTCTTAGCGCC
CTTCTTTGTTG -> TTCTTTGTTGA
CTTGAGCGCGA -> TTGAGCGCGAC
CTTGCTAAAGT -> TTGCTAAAGTA
CTTGCTACCCC -> TTGCTACCCCG
CTTGGTGTGTT -> TTGGTGTGTTC
CTTGGTTCCGG -> TTGGTTCCGGC
CTTGTATCCGC -> TTGTATCCGCG
CTTGTCCCGCG -> TTGTCCCGCGG
CTTGTTGCATC -> TTGTTGCATCT
CTTTGCGGAGG -> TTTGCGGAGGA
CTTTGTTGACT -> TTTGTTGACTT
CTTTTCGATCG -> TTTTCGATCGG
CTTTTTGATTA -> TTTTTGATTAC
GAAAATCTACA -> AAAATCTACAA
GAAACCATATT -> AAACCATATTC
GAAACGCTGGC -> AAACGCTGGCG
GAAACTTCGGG -> AAACTTCGGGG
GAAACTTGTCC -> AAACTTGTCCC
GAAAGACGATT -> AAAGACGATTT
GAAAGTCATAC -> AAAGTCATACG
GAAATCGTACT -> AAATCGTACTA
GAAATTCTGTG -> AAATTCTGTGA
GAACCCAATAA -> AACCCAATAAA
GAACCCCTTCC -> AACCCCTTCCA
GAACCCTGAAT -> AACCCTGAATT
GAACCTGCTCT -> AACCTGCTCTT
GAACGCTTACG -> AACGCTTACGA
GAACTACAGCG -> AACTACAGCGA
GAAGAGGCGTG -> AAGAGGCGTGA
GAAGAGTCATA -> AAGAGTCATAG
GAAGCCAAGCT -> AAGCCAAGCTG
GAAGCTGGACG -> AAGCTGGACGG
GAAGGTTTTAG -> AAGGTTTTAGG
GAAGTCCATAC -> AAGTCCATACG
GAAGTCCGCTC -> AAGTCCGCTCG
GAAGTGGTGCT -> AAGTGGTGCTA
GAATACATGGA -> AATACATGGAG
GAATAGTGAAG -> AATAGTGAAGT
GAATATAATAG -> AATATAATAGG
GAATGGCCGCC -> AATGGCCGCCT
GAATGGCGGCC -> AATGGCGGCCG
GAATGTCGGAT -> AATGTCGGATC
GAATTACAATT -> AATTACAATTG
GAATTGCGTTC -> AATTGCGTTCG
GAATTGTACCG -> AATTGTACCGA
GAATTTAGGGG -> AATTTAGGGGA
GAATTTTTTCG -> AATTTTTTCGG
GACAATGGGAT -> ACAATGGGATA
GACACATACGG -> ACACATACGGC
GACAGAACTAC -> ACAGAACTACA
GACAGGTTTTG -> ACAGGTTTTGC
GACATATGCGA -> ACATATGCGAC
GACATCCATGC -> ACATCCATGCC
GACATTTTGAC -> ACATTTTGACG
GACCAAGAGCA -> ACCAAGAGCAG
GACCACTCGCC -> ACCACTCGCCC
GACCCAGGGCA -> ACCCAGGGCAA
GACCCATATGT -> ACCCATATGTA
GACCCCCGATA -> ACCCCCGATAC
GACCCGCGGCG -> ACCCGCGGCGT
GACCGCACCCT -> ACCGCACCCTA
GACCGGCGTAC -> ACCGGCGTACC
GACCGTAACCA -> ACCGTAACCAA
GACCTACGCCC -> ACCTACGCCCT
GACCTCACTTA -> ACCTCACTTAG
GACCTCCCCAT -> ACCTCCCCATT
GACCTTAAATG -> ACCTTAAATGG
GACGACCGTAA -> ACGACCGTAAC
GACGACGTGTA -> ACGACGTGTAG
GACGACTCCCC -> ACGACTCCCCC
GACGACTTTGC -> ACGACTTTGCG
GACGATATCGC -> ACGATATCGCT
GACGATCCCAA -> ACGATCCCAAG
GACGATTTATT -> ACGATTTATTC
GACGCAATCCA -> ACGCAATCCAC
GACGCGTGCCG -> ACGCGTGCCGA
GACGGAACCCT -> ACGGAACCCTG
GACGGGCGTCC -> ACGGGCGTCCG
GACGGTGCCAG -> ACGGTGCCAGC
GACGTGTAGTT -> ACGTGTAGTTT
GACGTTTATCG -> ACGTTTATCGA
GACTAATGTAA -> ACTAATGTAAA
GACTACGGAGG -> ACTACGGAGGC
GACTCAGGGGC -> ACTCAGGGGCA
GACTCCCCCGG -> ACTCCCCCGGA
GACTCGAGGTG -> ACTCGAGGTGC
GACTCTTGTTG -> ACTCTTGTTGC
GACTGAAGAGG -> ACTGAAGAGGC
GACTGTCTAAC -> ACTGTCTAACG
GACTGTGAGGC -> ACTGTGAGGCG
GACTTAGATGT -> ACTTAGATGTC
GACTTCTTTGT -> ACTTCTTTGTT
GACTTGTATCC -> ACTTGTATCCG
GACTTTGCGGA -> ACTTTGCGGAG
GAGAAGAGTCA -> AGAAGAGTCAT
GAGAGATCGAT -> AGAGATCGATA
GAGATCGATAT -> AGATCGATATA
GAGATCGTACC -> AGATCGTACCA
GAGATGCTGAT -> AGATGCTGATC
GAGCACAGGCC -> AGCACAGGCCA
GAGCAGGGATT -> AGCAGGGATTT
GAGCCTTAGGA -> AGCCTTAGGAA
GAGCGATTCCT -> AGCGATTCCTT
GAGCGCGACGA -> AGCGCGACGAC
GAGCGTACACT -> AGCGTACACTG
GAGCGTTTGGG -> AGCGTTTGGGG
GAGCTCCCGGG -> AGCTCCCGGGA
GAGGAAGCTGG -> AGGAAGCTGGA
GAGGACGCGTG -> AGGACGCGTGC
GAGGCAGAAAA -> AGGCAGAAAAT
GAGGCAGAAAT -> AGGCAGAAATT
GAGGCAGAGAA -> AGGCAGAGAAG
GAGGCCGCCTG -> AGGCCGCCTGC
GAGGCGTGACG -> AGGCGTGACGA
GAGGCGTGACT -> AGGCGTGACTC
GAGGGCAAATA -> AGGGCAAATAC
GAGGTGCCAAG -> AGGTGCCAAGG
GAGTAACCGCT -> AGTAACCGCTG
GAGTCAGTCAA -> AGTCAGTCAAG
GAGTCATAGAG -> AGTCATAGAGC
GAGTCCACCGC -> AGTCCACCGCA
GAGTCCTGTGG -> AGTCCTGTGGG
GAGTGATTCGG -> AGTGATTCGGT
GATAATTAAAG -> ATAATTAAAGT
GATACGACCGC -> ATACGACCGCA
GATAGCATGAG -> ATAGCATGAGT
GATATACCAAA -> ATATACCAAAG
GATATCGCTTT -> ATATCGCTTTT
GATCCCAAGCC -> ATCCCAAGCCT
GATCGACCAAG -> ATCGACCAAGA
GATCGATATAC -> ATCGATATACC
GATCGGCTCCC -> ATCGGCTCCCG
GATCGGCTGAG -> ATCGGCTGAGT
GATCGGTAATT -> ATCGGTAATTA
GATCGTACCAC -> ATCGTACCACC
GATCTTAAATC -> ATCTTAAATCT
GATGACAGGTT -> ATGACAGGTTT
GATGACCGGCG -> ATGACCGGCGT
GATGAGTCCAC -> ATGAGTCCACC
GATGATCGGCT -> ATGATCGGCTG
GATGATTTGAC -> ATGATTTGACT
GATGCTGACTG -> ATGCTGACTGA
GATGCTGATCG -> ATGCTGATCGG
GATGGAGCGAT -> ATGGAGCGATT
GATGGCAGGAT -> ATGGCAGGATT
GATGGGTATTT -> ATGGGTATTTA
GATGGGTTCCA -> ATGGGTTCCAT
GATGTCGCGCT -> ATGTCGCGCTG
GATTACGCATG -> ATTACGCATGA
GATTATTGGGA -> ATTATTGGGAA
GATTCCAAGGT -> ATTCCAAGGTC
GATTCCTTCAA -> ATTCCTTCAAA
GATTCGAGGGC -> ATTCGAGGGCA
GATTCGGTCGC -> ATTCGGTCGCC
GATTTAAGTAT -> ATTTAAGTATC
GATTTATTCAG -> ATTTATTCAGC
GATTTCGCGTG -> ATTTCGCGTGG
GATTTGACGTT -> ATTTGACGTTT
GATTTGACTCA -> ATTTGACTCAG
GCAAAAATCCT -> CAAAAATCCTG
GCAAACTAAAG -> CAAACTAAAGA
GCAAATACCGG -> CAAATACCGGC
GCAACATTATG -> CAACATTATGT
GCAACCAATAT -> CAACCAATATA
GCAACTGCCCA -> CAACTGCCCAT
GCAAGACATTT -> CAAGACATTTT
GCAAGGGCGTG -> CAAGGGCGTGA
GCAATCCACCG -> CAATCCACCGC
GCAATTCATGA -> CAATTCATGAG
GCACAGGCCAG -> CACAGGCCAGC
GCACAGTCGCT -> CACAGTCGCTA
GCACATGAGCT -> CACATGAGCTC
GCACCCTAAAA -> CACCCTAAAAA
GCACCTGATCT -> CACCTGATCTT
GCACGTTCGAC -> CACGTTCGACT
GCAGAAAATCT -> CAGAAAATCTA
GCAGAAACGCT -> CAGAAACGCTG
GCAGAAATTCT -> CAGAAATTCTG
GCAGAGAAGAG -> CAGAGAAGAGT
GCAGAGGAAGC -> CAGAGGAAGCT
GCAGATAGCAT -> CAGATAGCATG
GCAGCTTATTC -> CAGCTTATTCG
GCAGGATTTAA -> CAGGATTTAAG
GCAGGGATTTC -> CAGGGATTTCG
GCAGTGGTGAC -> CAGTGGTGACC
GCATCTGTGCG -> CATCTGTGCGG
GCATGAATTGT -> CATGAATTGTA
GCATGACCCGC -> CATGACCCGCG
GCATGAGTCCT -> CATGAGTCCTG
GCATTAAAATG -> CATTAAAATGG
GCATTAGTATC -> CATTAGTATCC
GCATTGCGTTG -> CATTGCGTTGA
GCCAAGCTGAC -> CCAAGCTGACT
GCCAAGGAGGC -> CCAAGGAGGCA
GCCAGCACCTG -> CCAGCACCTGA
GCCAGCCAGGA -> CCAGCCAGGAC
GCCAGGACGGT -> CCAGGACGGTG
GCCATTTGATG -> CCATTTGATGG
GCCCAACTAAC -> CCCAACTAACT
GCCCAGCGGAT -> CCCAGCGGATG
GCCCATACACC -> CCCATACACCG
GCCCATTCGAA -> CCCATTCGAAA
GCCCGAATTAC -> CCCGAATTACA
GCCCTGCATTA -> CCCTGCATTAA
GCCGAAGCCAA -> CCGAAGCCAAG
GCCGAATAGTG -> CCGAATAGTGA
GCCGCCGGGTG -> CCGCCGGGTGT
GCCGCCTCACT -> CCGCCTCACTG
GCCGCCTGCGA -> CCGCCTGCGAA
GCCGCGGAATA -> CCGCGGAATAC
GCCGGGTGTCG -> CCGGGTGTCGA
GCCTACTTAGG -> CCTACTTAGGA
GCCTCACTGCG -> CCTCACTGCGA
GCCTCCGGTCA -> CCTCCGGTCAA
GCCTCCTTGCT -> CCTCCTTGCTA
GCCTGCGAACC -> CCTGCGAACCC
GCCTTAGGAAA -> CCTTAGGAAAC
GCCTTAGGTTC -> CCTTAGGTTCC
GCGAAATCGTA -> CGAAATCGTAC
GCGAACCCAAT -> CGAACCCAATA
GCGAAGTCCGC -> CGAAGTCCGCT
GCGACACATAC -> CGACACATACG
GCGACGACTTT -> CGACGACTTTG
GCGAGCCTTAG -> CGAGCCTTAGG
GCGATGATCGG -> CGATGATCGGC
GCGATGGGTTC -> CGATGGGTTCC
GCGATTCCTTC -> CGATTCCTTCA
GCGCATGAATT -> CGCATGAATTG
GCGCCTCCGGT -> CGCCTCCGGTC
GCGCCTCCTTG -> CGCCTCCTTGC
GCGCGACGACT -> CGCGACGACTT
GCGCGTCACCC -> CGCGTCACCCG
GCGCTGATGCT -> CGCTGATGCTG
GCGCTTAGATG -> CGCTTAGATGA
GCGGAATACAT -> CGGAATACATG
GCGGACATCCA -> CGGACATCCAT
GCGGACGACCG -> CGGACGACCGT
GCGGAGGACGC -> CGGAGGACGCG
GCGGATGAGTC -> CGGATGAGTCC
GCGGCAAGACA -> CGGCAAGACAT
GCGGCCGCGGA -> CGGCCGCGGAA
GCGGCGTTCTT -> CGGCGTTCTTC
GCGGCTCTTGA -> CGGCTCTTGAG
GCGGGTTCCAG -> CGGGTTCCAGC
GCGGTGGATTT -> CGGTGGATTTG
GCGTAATATTC -> CGTAATATTCG
GCGTACACTGC -> CGTACACTGCG
GCGTACCCACG -> CGTACCCACGC
GCGTCACCCGT -> CGTCACCCGTG
GCGTCCGCGCA -> CGTCCGCGCAT
GCGTGACCTAC -> CGTGACCTACG
GCGTGACGACG -> CGTGACGACGT
GCGTGACTCGA -> CGTGACTCGAG
GCGTGCCGAAT -> CGTGCCGAATA
GCGTGGAACCT -> CGTGGAACCTG
GCGTTCGTCTA -> CGTTCGTCTAC
GCGTTCTTCGC -> CGTTCTTCGCA
GCGTTGAAACT -> CGTTGAAACTT
GCGTTTGGGGC -> CGTTTGGGGCT
GCTAAAGTATC -> CTAAAGTATCC
GCTACACTCTT -> CTACACTCTTG
GCTACCCCGAG -> CTACCCCGAGG
GCTAGCGGACG -> CTAGCGGACGA
GCTATCCTAGA -> CTATCCTAGAA
GCTCACTAGGC -> CTCACTAGGCT
GCTCCAAGGGC -> CTCCAAGGGCA
GCTCCAGTGAC -> CTCCAGTGACC
GCTCCCCACGG -> CTCCCCACGGT
GCTCCCGGGAG -> CTCCCGGGAGC
GCTCCCGTCGC -> CTCCCGTCGCA
GCTCGAACGCT -> CTCGAACGCTT
GCTCGGCTCCA -> CTCGGCTCCAA
GCTCGTGTAAC -> CTCGTGTAACA
GCTCTCCTAAT -> CTCTCCTAATG
GCTCTTACCGC -> CTCTTACCGCT
GCTCTTGAGCG -> CTCTTGAGCGC
GCTGACTGAAG -> CTGACTGAAGA
GCTGACTGTGA -> CTGACTGTGAG
GCTGAGTCAGT -> CTGAGTCAGTC
GCTGATCGGTA -> CTGATCGGTAA
GCTGATGCTGA -> CTGATGCTGAC
GCTGGACGGGC -> CTGGACGGGCG
GCTGGCATTGC -> CTGGCATTGCG
GCTGGCGGCAA -> CTGGCGGCAAG
GCTGGTCCTTA -> CTGGTCCTTAA
GCTTACGACTA -> CTTACGACTAC
GCTTAGATGAC -> CTTAGATGACA
GCTTATTCGGA -> CTTATTCGGAT
GCTTCTTAGCG -> CTTCTTAGCGC
GCTTTTTGATT -> CTTTTTGATTA
GGAAACCATAT -> GAAACCATATT
GGAAAGACGAT -> GAAAGACGATT
GGAACCCCTTC -> GAACCCCTTCC
GGAACCCTGAA -> GAACCCTGAAT
GGAACCTGCTC -> GAACCTGCTCT
GGAAGCTGGAC -> GAAGCTGGACG
GGAATACATGG -> GAATACATGGA
GGAATATAATA -> GAATATAATAG
GGAATTGCGTT -> GAATTGCGTTC
GGAATTTTTTC -> GAATTTTTTCG
GGACATCCATG -> GACATCCATGC
GGACCCAGGGC -> GACCCAGGGCA
GGACGACCGTA -> GACGACCGTAA
GGACGCGTGCC -> GACGCGTGCCG
GGACGGGCGTC -> GACGGGCGTCC
GGACGGTGCCA -> GACGGTGCCAG
GGAGAGATCGA -> GAGAGATCGAT
GGAGCACAGGC -> GAGCACAGGCC
GGAGCGATTCC -> GAGCGATTCCT
GGAGGACGCGT -> GAGGACGCGTG
GGAGGCAGAAA -> GAGGCAGAAAA,GAGGCAGAAAT
GGAGGCAGAGA -> GAGGCAGAGAA
GGAGTAACCGC -> GAGTAACCGCT
GGATAATTAAA -> GATAATTAAAG
GGATCGACCAA -> GATCGACCAAG
GGATGAGTCCA -> GATGAGTCCAC
GGATGATTTGA -> GATGATTTGAC
GGATGGCAGGA -> GATGGCAGGAT
GGATTATTGGG -> GATTATTGGGA
GGATTTAAGTA -> GATTTAAGTAT
GGATTTCGCGT -> GATTTCGCGTG
GGATTTGACGT -> GATTTGACGTT
GGCAAATACCG -> GCAAATACCGG
GGCAACATTAT -> GCAACATTATG
GGCAACTGCCC -> GCAACTGCCCA
GGCAAGACATT -> GCAAGACATTT
GGCAGAAAATC -> GCAGAAAATCT
GGCAGAAACGC -> GCAGAAACGCT
GGCAGAAATTC -> GCAGAAATTCT
GGCAGAGAAGA -> GCAGAGAAGAG
GGCAGATAGCA -> GCAGATAGCAT
GGCAGCTTATT -> GCAGCTTATTC
GGCAGGATTTA -> GCAGGATTTAA
GGCAGTGGTGA -> GCAGTGGTGAC
GGCATTAGTAT -> GCATTAGTATC
GGCATTGCGTT -> GCATTGCGTTG
GGCCAGCCAGG -> GCCAGCCAGGA
GGCCATTTGAT -> GCCATTTGATG
GGCCGCCTCAC -> GCCGCCTCACT
GGCCGCCTGCG -> GCCGCCTGCGA
GGCCGCGGAAT -> GCCGCGGAATA
GGCGCCTCCTT -> GCGCCTCCTTG
GGCGGCAAGAC -> GCGGCAAGACA
GGCGGCCGCGG -> GCGGCCGCGGA
GGCGTACCCAC -> GCGTACCCACG
GGCGTCCGCGC -> GCGTCCGCGCA
GGCGTGACCTA -> GCGTGACCTAC
GGCGTGACGAC -> GCGTGACGACG
GGCGTGACTCG -> GCGTGACTCGA
GGCGTTCTTCG -> GCGTTCTTCGC
GGCTAGCGGAC -> GCTAGCGGACG
GGCTCCAAGGG -> GCTCCAAGGGC
GGCTCCCGTCG -> GCTCCCGTCGC
GGCTCGTGTAA -> GCTCGTGTAAC
GGCTCTCCTAA -> GCTCTCCTAAT
GGCTCTTGAGC -> GCTCTTGAGCG
GGCTGAGTCAG -> GCTGAGTCAGT
GGCTTCTTAGC -> GCTTCTTAGCG
GGGAAAGACGA -> GGAAAGACGAT
GGGAATTGCGT -> GGAATTGCGTT
GGGAGCACAGG -> GGAGCACAGGC
GGGATAATTAA -> GGATAATTAAA
GGGATGGCAGG -> GGATGGCAGGA
GGGATTTCGCG -> GGATTTCGCGT
GGGCAAATACC -> GGCAAATACCG
GGGCAACTGCC -> GGCAACTGCCC
GGGCAGATAGC -> GGCAGATAGCA
GGGCAGTGGTG -> GGCAGTGGTGA
GGGCATTAGTA -> GGCATTAGTAT
GGGCGTCCGCG -> GGCGTCCGCGC
GGGCGTGACCT -> GGCGTGACCTA
GGGCTTCTTAG -> GGCTTCTTAGC
GGGGAATTGCG -> GGGAATTGCGT
GGGGCAGATAG -> GGGCAGATAGC
GGGGCATTAGT -> GGGCATTAGTA
GGGGCTTCTTA -> GGGCTTCTTAG
GGGGTGTTCCT -> GGGTGTTCCTG
GGGTATTTACA -> GGTATTTACAT
GGGTCGGGTGT -> GGTCGGGTGTT
GGGTGCACGTT -> GGTGCACGTTC
GGGTGTCGACT -> GGTGTCGACTT
GGGTGTTCCTG -> GGTGTTCCTGA
GGGTGTTTTCC -> GGTGTTTTCCC
GGGTTCCAGCG -> GGTTCCAGCGT
GGGTTCCATAA -> GGTTCCATAAC
GGTAATTACGC -> GTAATTACGCC
GGTATTTACAT -> GTATTTACATG
GGTCAACGTAA -> GTCAACGTAAT
GGTCCGACGGA -> GTCCGACGGAA
GGTCCTTAACG -> GTCCTTAACGA
GGTCGCCTACT -> GTCGCCTACTT
GGTCGGGTGTT -> GTCGGGTGTTT
GGTGAAGGTTT -> GTGAAGGTTTT
GGTGACCCCCG -> GTGACCCCCGA
GGTGCACATGA -> GTGCACATGAG
GGTGCACGTTC -> GTGCACGTTCG
GGTGCCAAGGA -> GTGCCAAGGAG
GGTGCCAGCAC -> GTGCCAGCACC
GGTGCTACACT -> GTGCTACACTC
GGTGGATTTGA -> GTGGATTTGAC
GGTGTCGACTT -> GTGTCGACTTC
GGTGTGTTCGG -> GTGTGTTCGGC
GGTGTTCCTGA -> GTGTTCCTGAC
GGTGTTTTCCC -> GTGTTTTCCCG
GGTTCCAGCGT -> GTTCCAGCGTA
GGTTCCATAAC -> GTTCCATAACG
GGTTCCCGATG -> GTTCCCGATGA
GGTTCCCTGTT -> GTTCCCTGTTC
GGTTCCGGCAA -> GTTCCGGCAAC
GGTTTTAGGGG -> GTTTTAGGGGC
GGTTTTGCAAC -> GTTTTGCAACC
GTAAAAACTTG -> TAAAAACTTGG
GTAACAAGTCG -> TAACAAGTCGT
GTAACCAACGT -> TAACCAACGTC
GTAACCGCTGG -> TAACCGCTGGC
GTAAGGATGAT -> TAAGGATGATT
GTAATATTCGT -> TAATATTCGTG
GTAATCTCTAA -> TAATCTCTAAT
GTAATTACGCC -> TAATTACGCCC
GTAATTGATTC -> TAATTGATTCC
GTACACTGCGC -> TACACTGCGCG
GTACCACCTCC -> TACCACCTCCG
GTACCCACGCT -> TACCCACGCTG
GTACCGACGCA -> TACCGACGCAA
GTACTAACTCA -> TACTAACTCAA
GTAGACCCATA -> TAGACCCATAT
GTAGCCGAAGC -> TAGCCGAAGCC
GTAGTTGCTCG -> TAGTTGCTCGG
GTAGTTTGCGC -> TAGTTTGCGCT
GTATCACGTAG -> TATCACGTAGC
GTATCCCGTTA -> TATCCCGTTAT
GTATCCGCGAG -> TATCCGCGAGC
GTATCCTGCAA -> TATCCTGCAAA
GTATTTACATG -> TATTTACATGG
GTCAACGTAAT -> TCAACGTAATT
GTCAAGATGGG -> TCAAGATGGGT
GTCACCCGTGT -> TCACCCGTGTG
GTCAGTCAAGA -> TCAGTCAAGAT
GTCATACGTGA -> TCATACGTGAA
GTCATAGAGCG -> TCATAGAGCGT
GTCCACCGCAA -> TCCACCGCAAG
GTCCATACGCT -> TCCATACGCTC
GTCCCGCGGTG -> TCCCGCGGTGG
GTCCGACGGAA -> TCCGACGGAAC
GTCCGCGCATG -> TCCGCGCATGA
GTCCGCTCGAA -> TCCGCTCGAAC
GTCCGTTGCAG -> TCCGTTGCAGA
GTCCTGTGGGA -> TCCTGTGGGAT
GTCCTTAACGA -> TCCTTAACGAC
GTCGACTTCTT -> TCGACTTCTTT
GTCGCACAGTC -> TCGCACAGTCG
GTCGCCTACTT -> TCGCCTACTTA
GTCGCGCTGAT -> TCGCGCTGATG
GTCGCTATCCT -> TCGCTATCCTA
GTCGGAGAGAT -> TCGGAGAGATC
GTCGGATCGAC -> TCGGATCGACC
GTCGGCAGAAA -> TCGGCAGAAAC
GTCGGGTGTTT -> TCGGGTGTTTT
GTCGTCCGTTG -> TCGTCCGTTGC
GTCTAACGTAG -> TCTAACGTAGA
GTCTACCAAAA -> TCTACCAAAAT
GTGAAAGTCAT -> TGAAAGTCATA
GTGAAGGTTTT -> TGAAGGTTTTA
GTGAAGTCCAT -> TGAAGTCCATA
GTGAAGTGGTG -> TGAAGTGGTGC
GTGACAGAACT -> TGACAGAACTA
GTGACCACTCG -> TGACCACTCGC
GTGACCCCCGA -> TGACCCCCGAT
GTGACCTACGC -> TGACCTACGCC
GTGACCTTAAA -> TGACCTTAAAT
GTGACGACGTG -> TGACGACGTGT
GTGACTAATGT -> TGACTAATGTA
GTGACTCGAGG -> TGACTCGAGGT
GTGAGGCGTGA -> TGAGGCGTGAC
GTGATTCGGTC -> TGATTCGGTCG
GTGCACATGAG -> TGCACATGAGC
GTGCACGTTCG -> TGCACGTTCGA
GTGCCAAGGAG -> TGCCAAGGAGG
GTGCCAGCACC -> TGCCAGCACCT
GTGCCGAATAG -> TGCCGAATAGT
GTGCGGACATC -> TGCGGACATCC
GTGCGGCTCTT -> TGCGGCTCTTG
GTGCTACACTC -> TGCTACACTCT
GTGGAACCTGC -> TGGAACCTGCT
GTGGATTTGAC -> TGGATTTGACG
GTGGGATGGCA -> TGGGATGGCAG
GTGGTGACCCC -> TGGTGACCCCC
GTGGTGCTACA -> TGGTGCTACAC
GTGTAACAAGT -> TGTAACAAGTC
GTGTAGTTTGC -> TGTAGTTTGCG
GTGTCGACTTC -> TGTCGACTTCT
GTGTGACCTTA -> TGTGACCTTAA
GTGTGTTCGGC -> TGTGTTCGGCT
GTGTTCCTGAC -> TGTTCCTGACG
GTGTTCGGCTC -> TGTTCGGCTCT
GTGTTTTCCCG -> TGTTTTCCCGT
GTTACCAGTGA -> TTACCAGTGAC
GTTAGAATGGC -> TTAGAATGGCC
GTTAGACCTCA -> TTAGACCTCAC
GTTATGTAGTT -> TTATGTAGTTG
GTTATGTTACC -> TTATGTTACCA
GTTCAAGTTAG -> TTCAAGTTAGA
GTTCAATCGGT -> TTCAATCGGTG
GTTCCAGCGTA -> TTCCAGCGTAA
GTTCCATAACG -> TTCCATAACGA
GTTCCCGATGA -> TTCCCGATGAC
GTTCCCTGTTC -> TTCCCTGTTCA
GTTCCGGCAAC -> TTCCGGCAACA
GTTCCTGACGA -> TTCCTGACGAC
GTTCGACTTGT -> TTCGACTTGTA
GTTCGGCTCTC -> TTCGGCTCTCC
GTTCGTCTACC -> TTCGTCTACCA
GTTCTTCGCAA -> TTCTTCGCAAA
GTTGAAACTTC -> TTGAAACTTCG
GTTGACTTAGA -> TTGACTTAGAT
GTTGCAGAGGA -> TTGCAGAGGAA
GTTGCATCTGT -> TTGCATCTGTG
GTTGCTCGGCT -> TTGCTCGGCTC
GTTTATCGAGT -> TTTATCGAGTC
GTTTGCGCTTA -> TTTGCGCTTAG
GTTTGGGGCTT -> TTTGGGGCTTC
GTTTGTTCAAT -> TTTGTTCAATC
GTTTTAGGGGC -> TTTTAGGGGCA
GTTTTCCCGTG -> TTTTCCCGTGA
GTTTTGCAACC -> TTTTGCAACCA
TAAAAAACCTT -> AAAAAACCTTG
TAAAAACTTGG -> AAAAACTTGGT
TAAAATGGGTC -> AAAATGGGTCG
TAAACAGACAA -> AAACAGACAAT
TAAAGAATGGC -> AAAGAATGGCG
TAAAGTATCCT -> AAAGTATCCTG
TAAAGTTAGAC -> AAAGTTAGACC
TAAATCTCCGA -> AAATCTCCGAG
TAAATCTGAGA -> AAATCTGAGAT
TAAATGGTGCA -> AAATGGTGCAC
TAACAAGTCGT -> AACAAGTCGTC
TAACCAACGTC -> AACCAACGTCG
TAACCGCTGGC -> AACCGCTGGCA
TAACGACATAT -> AACGACATATG
TAACGAGTGAT -> AACGAGTGATT
TAACGTAGACC -> AACGTAGACCC
TAACTCAATAG -> AACTCAATAGT
TAACTTTTCGA -> AACTTTTCGAT
TAAGGATGATT -> AAGGATGATTT
TAAGTATCACG -> AAGTATCACGT
TAATAGGGTGC -> AATAGGGTGCA
TAATATTCGTG -> AATATTCGTGC
TAATCTCTAAT -> AATCTCTAATG
TAATGCGATGA -> AATGCGATGAT
TAATGCGGGTT -> AATGCGGGTTC
TAATGTAAAAA -> AATGTAAAAAC
TAATTAAAGTT -> AATTAAAGTTA
TAATTACGCCC -> AATTACGCCCA
TAATTGATTCC -> AATTGATTCCA
TACAATACCGA -> ACAATACCGAC
TACAATTGTTA -> ACAATTGTTAT
TACACCGCGAA -> ACACCGCGAAA
TACACTCTTGG -> ACACTCTTGGT
TACACTGCGCG -> ACACTGCGCGT
TACAGCGATGG -> ACAGCGATGGG
TACATGGAGGC -> ACATGGAGGCA
TACATGGCTCG -> ACATGGCTCGT
TACCAAAATGT -> ACCAAAATGTT
TACCAAAGACT -> ACCAAAGACTC
TACCACCTCCG -> ACCACCTCCGA
TACCAGTGACT -> ACCAGTGACTA
TACCCACGCTG -> ACCCACGCTGG
TACCCCGAGGC -> ACCCCGAGGCC
TACCGACCTCC -> ACCGACCTCCC
TACCGACGCAA -> ACCGACGCAAT
TACCGCTCCAG -> ACCGCTCCAGT
TACCGGCCATT -> ACCGGCCATTT
TACCTAAACAG -> ACCTAAACAGA
TACGACCGCAC -> ACGACCGCACC
TACGACTACGG -> ACGACTACGGA
TACGCATGACC -> ACGCATGACCC
TACGCCCAACT -> ACGCCCAACTA
TACGCCCTGCA -> ACGCCCTGCAT
TACGCTCCCCA -> ACGCTCCCCAC
TACGGAGGCAG -> ACGGAGGCAGA
TACGGCGCCTC -> ACGGCGCCTCC
TACGTGAAGTC -> ACGTGAAGTCC
TACTAACTCAA -> ACTAACTCAAT
TACTTAGGAGT -> ACTTAGGAGTA
TAGAATGGCCG -> AGAATGGCCGC
TAGAATGTCGG -> AGAATGTCGGA
TAGACCCATAT -> AGACCCATATG
TAGACCTCACT -> AGACCTCACTT
TAGAGCGTACA -> AGAGCGTACAC
TAGATGACAGG -> AGATGACAGGT
TAGATGTCGCG -> AGATGTCGCGC
TAGCAATTCAT -> AGCAATTCATG
TAGCATGAGTC -> AGCATGAGTCC
TAGCCCGAATT -> AGCCCGAATTA
TAGCCGAAGCC -> AGCCGAAGCCA
TAGCGCCTCCG -> AGCGCCTCCGG
TAGCGGACGAC -> AGCGGACGACC
TAGGAAACCAT -> AGGAAACCATA
TAGGAGTAACC -> AGGAGTAACCG
TAGGCTAGCGG -> AGGCTAGCGGA
TAGGGGAATTG -> AGGGGAATTGC
TAGGGGCAGAT -> AGGGGCAGATA
TAGGGTGCACG -> AGGGTGCACGT
TAGGTTCCCTG -> AGGTTCCCTGT
TAGTAAGGATG -> AGTAAGGATGA
TAGTATCCCGT -> AGTATCCCGTT
TAGTGAAGTGG -> AGTGAAGTGGT
TAGTTGCTCGG -> AGTTGCTCGGC
TAGTTTGCGCT -> AGTTTGCGCTT
TATAATAGGGT -> ATAATAGGGTG
TATACCAAAGA -> ATACCAAAGAC
TATACCTAAAC -> ATACCTAAACA
TATCACGTAGC -> ATCACGTAGCC
TATCCCGTTAT -> ATCCCGTTATG
TATCCGCGAGC -> ATCCGCGAGCC
TATCCTAGAAT -> ATCCTAGAATG
TATCCTGCAAA -> ATCCTGCAAAC
TATCGAGTCTC -> ATCGAGTCTCG
TATCGCTTTTT -> ATCGCTTTTTG
TATGCGACACA -> ATGCGACACAT
TATGTAATCTC -> ATGTAATCTCT
TATGTAGTTGC -> ATGTAGTTGCT
TATGTCGGAGA -> ATGTCGGAGAG
TATGTTACCAG -> ATGTTACCAGT
TATTAGCCCGA -> ATTAGCCCGAA
TATTCAGCTCA -> ATTCAGCTCAC
TATTCGGATTA -> ATTCGGATTAT
TATTCGGCAGC -> ATTCGGCAGCT
TATTCGTGCGG -> ATTCGTGCGGC
TATTGGGAAAG -> ATTGGGAAAGA
TATTTACATGG -> ATTTACATGGC
TCAAAGGAATT -> CAAAGGAATTT
TCAACGTAATT -> CAACGTAATTG
TCAAGATGGGT -> CAAGATGGGTA
TCAAGTTAGAA -> CAAGTTAGAAT
TCAATAGTAAG -> CAATAGTAAGG
TCAATCGGTGA -> CAATCGGTGAA
TCACCCGTGTG -> CACCCGTGTGA
TCACGTAGCCG -> CACGTAGCCGA
TCACTAGGCTA -> CACTAGGCTAG
TCACTGCGAAG -> CACTGCGAAGT
TCACTTAGCAA -> CACTTAGCAAT
TCAGCTCACTA -> CAGCTCACTAG
TCAGGGGCATT -> CAGGGGCATTA
TCAGTCAAGAT -> CAGTCAAGATG
TCATACGTGAA -> CATACGTGAAG
TCATAGAGCGT -> CATAGAGCGTA
TCATGAGCGTT -> CATGAGCGTTT
TCCAAGGGCAG -> CCAAGGGCAGT
TCCAAGGTCCG -> CCAAGGTCCGA
TCCACCGCAAG -> CCACCGCAAGG
TCCACCGCCGC -> CCACCGCCGCC
TCCAGCGTAAT -> CCAGCGTAATA
TCCAGGAATAT -> CCAGGAATATA
TCCAGTGACCA -> CCAGTGACCAC
TCCATAACGAG -> CCATAACGAGT
TCCATACGCTC -> CCATACGCTCC
TCCATGCCCAT -> CCATGCCCATT
TCCCAAGCCTT -> CCCAAGCCTTA
TCCCCACGGTT -> CCCCACGGTTC
TCCCCATTTAT -> CCCCATTTATT
TCCCCCGGACC -> CCCCCGGACCC
TCCCGATGACC -> CCCGATGACCG
TCCCGCGGTGG -> CCCGCGGTGGA
TCCCGGGAGCA -> CCCGGGAGCAC
TCCCGTCGCAC -> CCCGTCGCACA
TCCCGTGACAG -> CCCGTGACAGA
TCCCGTTATGT -> CCCGTTATGTT
TCCCTGTTCAA -> CCCTGTTCAAG
TCCGACGATAT -> CCGACGATATC
TCCGACGGAAC -> CCGACGGAACC
TCCGAGATCGT -> CCGAGATCGTA
TCCGCGAGCCT -> CCGCGAGCCTT
TCCGCGCATGA -> CCGCGCATGAA
TCCGCTCGAAC -> CCGCTCGAACG
TCCGGCAACAT -> CCGGCAACATT
TCCGGTCAACG -> CCGGTCAACGT
TCCGTTGCAGA -> CCGTTGCAGAG
TCCTAATGCGA -> CCTAATGCGAT
TCCTAGAATGT -> CCTAGAATGTC
TCCTGACGACT -> CCTGACGACTC
TCCTGACTGTC -> CCTGACTGTCT
TCCTGCAAACT -> CCTGCAAACTA
TCCTGTGGGAT -> CCTGTGGGATG
TCCTTAACGAC -> CCTTAACGACA
TCCTTCAAAGG -> CCTTCAAAGGA
TCCTTGCTAAA -> CCTTGCTAAAG
TCGAAACTTGT -> CGAAACTTGTC
TCGAACGCTTA -> CGAACGCTTAC
TCGACCAAGAG -> CGACCAAGAGC
TCGACTTCTTT -> CGACTTCTTTG
TCGACTTGTAT -> CGACTTGTATC
TCGAGGGCAAA -> CGAGGGCAAAT
TCGAGGTGCCA -> CGAGGTGCCAA
TCGATATACCA -> CGATATACCAA
TCGATCGGCTC -> CGATCGGCTCC
TCGCAAAAATC -> CGCAAAAATCC
TCGCACAGTCG -> CGCACAGTCGC
TCGCCCAGCGG -> CGCCCAGCGGA
TCGCCTACTTA -> CGCCTACTTAG
TCGCGCTGATG -> CGCGCTGATGC
TCGCGTGGAAC -> CGCGTGGAACC
TCGCTATCCTA -> CGCTATCCTAG
TCGCTTTTTGA -> CGCTTTTTGAT
TCGGAACCCCT -> CGGAACCCCTT
TCGGAGAGATC -> CGGAGAGATCG
TCGGATCGACC -> CGGATCGACCA
TCGGATTATTG -> CGGATTATTGG
TCGGCAGAAAC -> CGGCAGAAACG
TCGGCAGCTTA -> CGGCAGCTTAT
TCGGCTCCAAG -> CGGCTCCAAGG
TCGGCTCCCGT -> CGGCTCCCGTC
TCGGCTCTCCT -> CGGCTCTCCTA
TCGGCTGAGTC -> CGGCTGAGTCA
TCGGGGTGTTC -> CGGGGTGTTCC
TCGGGTGTTTT -> CGGGTGTTTTC
TCGGTAATTAC -> CGGTAATTACG
TCGGTCGCCTA -> CGGTCGCCTAC
TCGGTGAAGGT -> CGGTGAAGGTT
TCGTACCACCT -> CGTACCACCTC
TCGTACTAACT -> CGTACTAACTC
TCGTCCGTTGC -> CGTCCGTTGCA
TCGTCTACCAA -> CGTCTACCAAA
TCGTGCGGCTC -> CGTGCGGCTCT
TCGTGTAACAA -> CGTGTAACAAG
TCTAACGTAGA -> CTAACGTAGAC
TCTAATGCGGG -> CTAATGCGGGT
TCTACAATACC -> CTACAATACCG
TCTACCAAAAT -> CTACCAAAATG
TCTCCGAGATC -> CTCCGAGATCG
TCTCCTAATGC -> CTCCTAATGCG
TCTCTAATGCG -> CTCTAATGCGG
TCTGAGATGCT -> CTGAGATGCTG
TCTGTGAAAGT -> CTGTGAAAGTC
TCTGTGCGGAC -> CTGTGCGGACA
TCTTAAATCTC -> CTTAAATCTCC
TCTTACCGCTC -> CTTACCGCTCC
TCTTAGCGCCT -> CTTAGCGCCTC
TCTTCGCAAAA -> CTTCGCAAAAA
TCTTGAGCGCG -> CTTGAGCGCGA
TCTTGGTGTGT -> CTTGGTGTGTT
TCTTGTTGCAT -> CTTGTTGCATC
TCTTTGTTGAC -> CTTTGTTGACT
TGAAACTTCGG -> GAAACTTCGGG
TGAAAGTCATA -> GAAAGTCATAC
TGAAGAGGCGT -> GAAGAGGCGTG
TGAAGGTTTTA -> GAAGGTTTTAG
TGAAGTCCATA -> GAAGTCCATAC
TGAAGTGGTGC -> GAAGTGGTGCT
TGAATTGTACC -> GAATTGTACCG
TGAATTTAGGG -> GAATTTAGGGG
TGACAGAACTA -> GACAGAACTAC
TGACAGGTTTT -> GACAGGTTTTG
TGACCACTCGC -> GACCACTCGCC
TGACCCCCGAT -> GACCCCCGATA
TGACCCGCGGC -> GACCCGCGGCG
TGACCGGCGTA -> GACCGGCGTAC
TGACCTACGCC -> GACCTACGCCC
TGACCTTAAAT -> GACCTTAAATG
TGACGACGTGT -> GACGACGTGTA
TGACGACTCCC -> GACGACTCCCC
TGACGATCCCA -> GACGATCCCAA
TGACGTTTATC -> GACGTTTATCG
TGACTAATGTA -> GACTAATGTAA
TGACTCAGGGG -> GACTCAGGGGC
TGACTCGAGGT -> GACTCGAGGTG
TGACTGAAGAG -> GACTGAAGAGG
TGACTGTCTAA -> GACTGTCTAAC
TGACTGTGAGG -> GACTGTGAGGC
TGACTTAGATG -> GACTTAGATGT
TGAGATGCTGA -> GAGATGCTGAT
TGAGCGCGACG -> GAGCGCGACGA
TGAGCGTTTGG -> GAGCGTTTGGG
TGAGCTCCCGG -> GAGCTCCCGGG
TGAGGCGTGAC -> GAGGCGTGACT
TGAGTCAGTCA -> GAGTCAGTCAA
TGAGTCCACCG -> GAGTCCACCGC
TGAGTCCTGTG -> GAGTCCTGTGG
TGATCGGCTGA -> GATCGGCTGAG
TGATCGGTAAT -> GATCGGTAATT
TGATCTTAAAT -> GATCTTAAATC
TGATGCTGACT -> GATGCTGACTG
TGATGGAGCGA -> GATGGAGCGAT
TGATTACGCAT -> GATTACGCATG
TGATTCCAAGG -> GATTCCAAGGT
TGATTCGGTCG -> GATTCGGTCGC
TGATTTGACTC -> GATTTGACTCA
TGCAAACTAAA -> GCAAACTAAAG
TGCAACCAATA -> GCAACCAATAT
TGCACATGAGC -> GCACATGAGCT
TGCACGTTCGA -> GCACGTTCGAC
TGCAGAGGAAG -> GCAGAGGAAGC
TGCATCTGTGC -> GCATCTGTGCG
TGCATTAAAAT -> GCATTAAAATG
TGCCAAGGAGG -> GCCAAGGAGGC
TGCCAGCACCT -> GCCAGCACCTG
TGCCCATACAC -> GCCCATACACC
TGCCCATTCGA -> GCCCATTCGAA
TGCCGAATAGT -> GCCGAATAGTG
TGCGAACCCAA -> GCGAACCCAAT
TGCGAAGTCCG -> GCGAAGTCCGC
TGCGACACATA -> GCGACACATAC
TGCGATGATCG -> GCGATGATCGG
TGCGCGTCACC -> GCGCGTCACCC
TGCGCTTAGAT -> GCGCTTAGATG
TGCGGACATCC -> GCGGACATCCA
TGCGGAGGACG -> GCGGAGGACGC
TGCGGCTCTTG -> GCGGCTCTTGA
TGCGGGTTCCA -> GCGGGTTCCAG
TGCGTTCGTCT -> GCGTTCGTCTA
TGCGTTGAAAC -> GCGTTGAAACT
TGCTAAAGTAT -> GCTAAAGTATC
TGCTACACTCT -> GCTACACTCTT
TGCTACCCCGA -> GCTACCCCGAG
TGCTCGGCTCC -> GCTCGGCTCCA
TGCTCTTACCG -> GCTCTTACCGC
TGCTGACTGAA -> GCTGACTGAAG
TGCTGATCGGT -> GCTGATCGGTA
TGGAACCTGCT -> GGAACCTGCTC
TGGACGGGCGT -> GGACGGGCGTC
TGGAGCGATTC -> GGAGCGATTCC
TGGAGGCAGAA -> GGAGGCAGAAA
TGGATTTGACG -> GGATTTGACGT
TGGCAGGATTT -> GGCAGGATTTA
TGGCATTGCGT -> GGCATTGCGTT
TGGCCGCCTCA -> GGCCGCCTCAC
TGGCGGCAAGA -> GGCGGCAAGAC
TGGCGGCCGCG -> GGCGGCCGCGG
TGGCTCGTGTA -> GGCTCGTGTAA
TGGGAAAGACG -> GGGAAAGACGA
TGGGATAATTA -> GGGATAATTAA
TGGGATGGCAG -> GGGATGGCAGG
TGGGGCTTCTT -> GGGGCTTCTTA
TGGGTATTTAC -> GGGTATTTACA
TGGGTCGGGTG -> GGGTCGGGTGT
TGGGTTCCATA -> GGGTTCCATAA
TGGTCCTTAAC -> GGTCCTTAACG
TGGTGACCCCC -> GGTGACCCCCG
TGGTGCACATG -> GGTGCACATGA
TGGTGCTACAC -> GGTGCTACACT
TGGTGTGTTCG -> GGTGTGTTCGG
TGGTTCCGGCA -> GGTTCCGGCAA
TGTAAAAACTT -> GTAAAAACTTG
TGTAACAAGTC -> GTAACAAGTCG
TGTAATCTCTA -> GTAATCTCTAA
TGTACCGACGC -> GTACCGACGCA
TGTAGTTGCTC -> GTAGTTGCTCG
TGTAGTTTGCG -> GTAGTTTGCGC
TGTATCCGCGA -> GTATCCGCGAG
TGTCCCGCGGT -> GTCCCGCGGTG
TGTCGACTTCT -> GTCGACTTCTT
TGTCGCGCTGA -> GTCGCGCTGAT
TGTCGGAGAGA -> GTCGGAGAGAT
TGTCGGATCGA -> GTCGGATCGAC
TGTCTAACGTA -> GTCTAACGTAG
TGTGAAAGTCA -> GTGAAAGTCAT
TGTGACCTTAA -> GTGACCTTAAA
TGTGAGGCGTG -> GTGAGGCGTGA
TGTGCGGACAT -> GTGCGGACATC
TGTGGGATGGC -> GTGGGATGGCA
TGTGTTCGGCT -> GTGTTCGGCTC
TGTTACCAGTG -> GTTACCAGTGA
TGTTATGTAGT -> GTTATGTAGTT
TGTTCAAGTTA -> GTTCAAGTTAG
TGTTCAATCGG -> GTTCAATCGGT
TGTTCCTGACG -> GTTCCTGACGA
TGTTCGGCTCT -> GTTCGGCTCTC
TGTTGACTTAG -> GTTGACTTAGA
TGTTGCATCTG -> GTTGCATCTGT
TGTTTGTTCAA -> GTTTGTTCAAT
TGTTTTCCCGT -> GTTTTCCCGTG
TTAAAATGGGT -> TAAAATGGGTC
TTAAAGTTAGA -> TAAAGTTAGAC
TTAAATCTCCG -> TAAATCTCCGA
TTAAATGGTGC -> TAAATGGTGCA
TTAACGACATA -> TAACGACATAT
TTAAGTATCAC -> TAAGTATCACG
TTACAATTGTT -> TACAATTGTTA
TTACATGGCTC -> TACATGGCTCG
TTACCAGTGAC -> TACCAGTGACT
TTACCGCTCCA -> TACCGCTCCAG
TTACGACTACG -> TACGACTACGG
TTACGCATGAC -> TACGCATGACC
TTACGCCCAAC -> TACGCCCAACT
TTAGAATGGCC -> TAGAATGGCCG
TTAGACCTCAC -> TAGACCTCACT
TTAGATGACAG -> TAGATGACAGG
TTAGATGTCGC -> TAGATGTCGCG
TTAGCAATTCA -> TAGCAATTCAT
TTAGCCCGAAT -> TAGCCCGAATT
TTAGCGCCTCC -> TAGCGCCTCCG
TTAGGAAACCA -> TAGGAAACCAT
TTAGGAGTAAC -> TAGGAGTAACC
TTAGGGGAATT -> TAGGGGAATTG
TTAGGGGCAGA -> TAGGGGCAGAT
TTAGGTTCCCT -> TAGGTTCCCTG
TTAGTATCCCG -> TAGTATCCCGT
TTATCGAGTCT -> TATCGAGTCTC
TTATGTAGTTG -> TATGTAGTTGC
TTATGTCGGAG -> TATGTCGGAGA
TTATGTTACCA -> TATGTTACCAG
TTATTAGCCCG -> TATTAGCCCGA
TTATTCAGCTC -> TATTCAGCTCA
TTATTCGGATT -> TATTCGGATTA
TTATTGGGAAA -> TATTGGGAAAG
TTCAAAGGAAT -> TCAAAGGAATT
TTCAAGTTAGA -> TCAAGTTAGAA
TTCAATCGGTG -> TCAATCGGTGA
TTCAGCTCACT -> TCAGCTCACTA
TTCATGAGCGT -> TCATGAGCGTT
TTCCAAGGTCC -> TCCAAGGTCCG
TTCCAGCGTAA -> TCCAGCGTAAT
TTCCAGGAATA -> TCCAGGAATAT
TTCCATAACGA -> TCCATAACGAG
TTCCCGATGAC -> TCCCGATGACC
TTCCCGTGACA -> TCCCGTGACAG
TTCCCTGTTCA -> TCCCTGTTCAA
TTCCGGCAACA -> TCCGGCAACAT
TTCCTGACGAC -> TCCTGACGACT
TTCCTTCAAAG -> TCCTTCAAAGG
TTCGAAACTTG -> TCGAAACTTGT
TTCGACTTGTA -> TCGACTTGTAT
TTCGAGGGCAA -> TCGAGGGCAAA
TTCGATCGGCT -> TCGATCGGCTC
TTCGCAAAAAT -> TCGCAAAAATC
TTCGCGTGGAA -> TCGCGTGGAAC
TTCGGAACCCC -> TCGGAACCCCT
TTCGGATTATT -> TCGGATTATTG
TTCGGCAGCTT -> TCGGCAGCTTA
TTCGGCTCTCC -> TCGGCTCTCCT
TTCGGGGTGTT -> TCGGGGTGTTC
TTCGGTCGCCT -> TCGGTCGCCTA
TTCGTCTACCA -> TCGTCTACCAA
TTCGTGCGGCT -> TCGTGCGGCTC
TTCTGTGAAAG -> TCTGTGAAAGT
TTCTTAGCGCC -> TCTTAGCGCCT
TTCTTCGCAAA -> TCTTCGCAAAA
TTCTTTGTTGA -> TCTTTGTTGAC
TTGAAACTTCG -> TGAAACTTCGG
TTGACGATCCC -> TGACGATCCCA
TTGACGTTTAT -> TGACGTTTATC
TTGACTCAGGG -> TGACTCAGGGG
TTGACTTAGAT -> TGACTTAGATG
TTGAGCGCGAC -> TGAGCGCGACG
TTGATGGAGCG -> TGATGGAGCGA
TTGATTACGCA -> TGATTACGCAT
TTGATTCCAAG -> TGATTCCAAGG
TTGCAACCAAT -> TGCAACCAATA
TTGCAGAGGAA -> TGCAGAGGAAG
TTGCATCTGTG -> TGCATCTGTGC
TTGCGCTTAGA -> TGCGCTTAGAT
TTGCGGAGGAC -> TGCGGAGGACG
TTGCGTTCGTC -> TGCGTTCGTCT
TTGCGTTGAAA -> TGCGTTGAAAC
TTGCTAAAGTA -> TGCTAAAGTAT
TTGCTACCCCG -> TGCTACCCCGA
TTGCTCGGCTC -> TGCTCGGCTCC
TTGGGAAAGAC -> TGGGAAAGACG
TTGGGGCTTCT -> TGGGGCTTCTT
TTGGTGTGTTC -> TGGTGTGTTCG
TTGGTTCCGGC -> TGGTTCCGGCA
TTGTACCGACG -> TGTACCGACGC
TTGTATCCGCG -> TGTATCCGCGA
TTGTCCCGCGG -> TGTCCCGCGGT
TTGTTATGTAG -> TGTTATGTAGT
TTGTTCAATCG -> TGTTCAATCGG
TTGTTGACTTA -> TGTTGACTTAG
TTGTTGCATCT -> TGTTGCATCTG
TTTAAGTATCA -> TTAAGTATCAC
TTTACATGGCT -> TTACATGGCTC
TTTAGGGGAAT -> TTAGGGGAATT
TTTAGGGGCAG -> TTAGGGGCAGA
TTTATCGAGTC -> TTATCGAGTCT
TTTATTAGCCC -> TTATTAGCCCG
TTTATTCAGCT -> TTATTCAGCTC
TTTCCCGTGAC -> TTCCCGTGACA
TTTCGATCGGC -> TTCGATCGGCT
TTTCGCGTGGA -> TTCGCGTGGAA
TTTCGGAACCC -> TTCGGAACCCC
TTTGACGATCC -> TTGACGATCCC
TTTGACGTTTA -> TTGACGTTTAT
TTTGACTCAGG -> TTGACTCAGGG
TTTGATGGAGC -> TTGATGGAGCG
TTTGATTACGC -> TTGATTACGCA
TTTGCAACCAA -> TTGCAACCAAT
TTTGCGCTTAG -> TTGCGCTTAGA
TTTGCGGAGGA -> TTGCGGAGGAC
TTTGGGGCTTC -> TTGGGGCTTCT
TTTGTTCAATC -> TTGTTCAATCG
TTTGTTGACTT -> TTGTTGACTTA
TTTTAGGGGCA -> TTTAGGGGCAG
TTTTCCCGTGA -> TTTCCCGTGAC
TTTTCGATCGG -> TTTCGATCGGC
TTTTCGGAACC -> TTTCGGAACCC
TTTTGACGATC -> TTTGACGATCC
TTTTGATTACG -> TTTGATTACGC
TTTTGCAACCA -> TTTGCAACCAA
TTTTTCGGAAC -> TTTTCGGAACC
TTTTTGATTAC -> TTTTGATTACG
TTTTTTCGGAA -> TTTTTCGGAAC
