TCGAAAGAAGCTAAATTCAGATTC -> CGAAAGAAGCTAAATTCAGATTCG
AGACAGCGTTATGCTGGATCGTAA -> GACAGCGTTATGCTGGATCGTAAA
ATGTCGTGGGTAGCGTAACGGCCT -> TGTCGTGGGTAGCGTAACGGCCTT
GGTTGATTGATTGCATACTAGGTG -> GTTGATTGATTGCATACTAGGTGC
TCAGTAACTTTGTGCTTGCGACCC -> CAGTAACTTTGTGCTTGCGACCCC
TTGTGACGTTATTAGTCATCTGGT -> TGTGACGTTATTAGTCATCTGGTT
GATGCCGAGCGTACGTCAAAGGCA -> ATGCCGAGCGTACGTCAAAGGCAA
GGTAATAAAACAGACATTATCCTT -> GTAATAAAACAGACATTATCCTTT
ATCAATTTCAATCAAAGAGCCCTC -> TCAATTTCAATCAAAGAGCCCTCA
ATATAACCCCAGCGCGTTCGTAAA -> TATAACCCCAGCGCGTTCGTAAAA
GTGAGACATCGAAAGTCAGCCGAA -> TGAGACATCGAAAGTCAGCCGAAC
AAACTGTGGGGCCTCTGGTTTTCC -> AACTGTGGGGCCTCTGGTTTTCCA
CCCGCAGGCCTTTAACTCGTAACA -> CCGCAGGCCTTTAACTCGTAACAG
CCGGGGCTAGGCATCCTTGCCCGG -> CGGGGCTAGGCATCCTTGCCCGGA
GGTGCTCTCTATAGCGCCCCCTAA -> GTGCTCTCTATAGCGCCCCCTAAA
TCAATTTCAATCAAAGAGCCCTCA -> CAATTTCAATCAAAGAGCCCTCAT
CAGTAACTTTGTGCTTGCGACCCC -> AGTAACTTTGTGCTTGCGACCCCT
TCTTTAGTAAAGACCTATTTGTAA -> CTTTAGTAAAGACCTATTTGTAAT
TTGGTTGCGGGGCATGTCGAGTAT -> TGGTTGCGGGGCATGTCGAGTATC
GAGGTAATAAAACAGACATTATCC -> AGGTAATAAAACAGACATTATCCT
ATTTTGTCAGCAGCACAACTAAGG -> TTTTGTCAGCAGCACAACTAAGGT
GAGGGAATTATGCAATTTGACTTA -> AGGGAATTATGCAATTTGACTTAT
TCAGGTTGTGGGGTCACCTTTAAC -> CAGGTTGTGGGGTCACCTTTAACA
ATTTGGGGTGGCACATGCTTAGTC -> TTTGGGGTGGCACATGCTTAGTCG
CCCAGCGCGTTCGTAAAACAATCG -> CCAGCGCGTTCGTAAAACAATCGC
GATAGATGGTTGAGGGGCCCGACT -> ATAGATGGTTGAGGGGCCCGACTC
CACCGGTCCATTCACCTTGTCGCG -> ACCGGTCCATTCACCTTGTCGCGC
GGCGAGACTGCATGACATCATCCC -> GCGAGACTGCATGACATCATCCCG
CAAAGATAGATGGTTGAGGGGCCC -> AAAGATAGATGGTTGAGGGGCCCG
TCAATCAAAGAGCCCTCATTAACG -> CAATCAAAGAGCCCTCATTAACGC
TTTCTATGCGGTGCAGTAACTCGC -> TTCTATGCGGTGCAGTAACTCGCG
CCTGTAGTAGGAAGGCTAACATCA -> CTGTAGTAGGAAGGCTAACATCAT
GATCAACCCGCTACCAACAAATTA -> ATCAACCCGCTACCAACAAATTAA
GCAAAGATAGATGGTTGAGGGGCC -> CAAAGATAGATGGTTGAGGGGCCC
GTGCTCTCTATAGCGCCCCCTAAA -> TGCTCTCTATAGCGCCCCCTAAAT
AGTCATCTGGTTGTGTTACTGGGA -> GTCATCTGGTTGTGTTACTGGGAG
CCAACAAATTAATATTGGACGCGC -> CAACAAATTAATATTGGACGCGCA
CTTGCCCGGAATGCCTGAATATGT -> TTGCCCGGAATGCCTGAATATGTA
TAGTTGGAACCAGTATATCGAGGG -> AGTTGGAACCAGTATATCGAGGGA
AGTAACAAGTACGACTGGGCGGCT -> GTAACAAGTACGACTGGGCGGCTC
ATTAGTCATCTGGTTGTGTTACTG -> TTAGTCATCTGGTTGTGTTACTGG
TGTGGGGCCTCTGGTTTTCCAGCT -> GTGGGGCCTCTGGTTTTCCAGCTC
AAAGGCAGGTGTACTAAGGCGTGT -> AAGGCAGGTGTACTAAGGCGTGTT
GTAGCGTAACGGCCTTCAATGTCG -> TAGCGTAACGGCCTTCAATGTCGT
AGTAGCAGGCTGTTGAGCAATAGA -> GTAGCAGGCTGTTGAGCAATAGAT
GCATACTAGGTGCTCTCTATAGCG -> CATACTAGGTGCTCTCTATAGCGC
TCTGTTCATAAAAAACGCTAAACT -> CTGTTCATAAAAAACGCTAAACTG
TGGGTGAGACATCGAAAGTCAGCC -> GGGTGAGACATCGAAAGTCAGCCG
TTGCGACCCCTTACCAATCTAGAA -> TGCGACCCCTTACCAATCTAGAAG
CAACAAATTAATATTGGACGCGCA -> AACAAATTAATATTGGACGCGCAG
AATGGCTCTGATCTGACTTTAGCC -> ATGGCTCTGATCTGACTTTAGCCG
TCCTCCGGGGCTAGGCATCCTTGC -> CCTCCGGGGCTAGGCATCCTTGCC
TGATGAGCCCCCGATCACCTAACG -> GATGAGCCCCCGATCACCTAACGC
CTCAGTTTCCCACTTATTTAAGAC -> TCAGTTTCCCACTTATTTAAGACT
TTGGGGTGGCACATGCTTAGTCGC -> TGGGGTGGCACATGCTTAGTCGCA
CTTGTGAATCGCTGTTATGAACCG -> TTGTGAATCGCTGTTATGAACCGC
GAGACTGCATGACATCATCCCGAG -> AGACTGCATGACATCATCCCGAGG
ATTCAGAGGATGCGCTTGGAAAAT -> TTCAGAGGATGCGCTTGGAAAATC
CAAGGCCTGTAGTAGGAAGGCTAA -> AAGGCCTGTAGTAGGAAGGCTAAC
GGTGTACTAAGGCGTGTTAGCCAA -> GTGTACTAAGGCGTGTTAGCCAAA
AAATGATGACCTATATGTAACTCT -> AATGATGACCTATATGTAACTCTT
AGTGTACATTCTGTTCATAAAAAA -> GTGTACATTCTGTTCATAAAAAAC
TCAGCAGCACAACTAAGGTATTTA -> CAGCAGCACAACTAAGGTATTTAT
TCACCTAACGCTATGACTGGCTTC -> CACCTAACGCTATGACTGGCTTCA
AGAACTGAGGCGAGACTGCATGAC -> GAACTGAGGCGAGACTGCATGACA
TATTTGTAATTTGGGGTGGCACAT -> ATTTGTAATTTGGGGTGGCACATG
TGCCGTGCCTTGGCTAACGCGTCT -> GCCGTGCCTTGGCTAACGCGTCTC
AACGGGCGCACCCCTATACTCACA -> ACGGGCGCACCCCTATACTCACAA
CTTTTCCCCCCCTCAAGGCCTGTA -> TTTTCCCCCCCTCAAGGCCTGTAG
CTGAATATGTACGACGGCCACATT -> TGAATATGTACGACGGCCACATTC
ACTTTAGCCGTGGTCCACTTCTTT -> CTTTAGCCGTGGTCCACTTCTTTA
GCCTGAATATGTACGACGGCCACA -> CCTGAATATGTACGACGGCCACAT
GTAACTCCGGCCACCAAACCGGTG -> TAACTCCGGCCACCAAACCGGTGG
CTAGGCACTATTACCGCGCATCTT -> TAGGCACTATTACCGCGCATCTTG
TCCGGGGCTAGGCATCCTTGCCCG -> CCGGGGCTAGGCATCCTTGCCCGG
CTAGGCATCCTTGCCCGGAATGCC -> TAGGCATCCTTGCCCGGAATGCCT
CACAACATTAAGACTATGTATTTA -> ACAACATTAAGACTATGTATTTAG
TAATAACAGGGGTTACAGTAGAGG -> AATAACAGGGGTTACAGTAGAGGG
AGGATGCGCTTGGAAAATCTTGTT -> GGATGCGCTTGGAAAATCTTGTTT
TTGGCGGAACAGTGGGGTGCAGAA -> TGGCGGAACAGTGGGGTGCAGAAC
TGCTAGTAGTAACAAGTACGACTG -> GCTAGTAGTAACAAGTACGACTGG
TTCAAAAGTTGTCAACGTATTCCT -> TCAAAAGTTGTCAACGTATTCCTT
CAGGTTGTGGGGTCACCTTTAACA -> AGGTTGTGGGGTCACCTTTAACAG
ACACGACGAGCACGTCGGTCTTGT -> CACGACGAGCACGTCGGTCTTGTG
TTTCCCCCCCTCAAGGCCTGTAGT -> TTCCCCCCCTCAAGGCCTGTAGTA
GTCCACGAGAACGGGCGCACCCCT -> TCCACGAGAACGGGCGCACCCCTA
GACATCGAAAGTCAGCCGAACGGC -> ACATCGAAAGTCAGCCGAACGGCA
AACCCCAGCGCGTTCGTAAAACAA -> ACCCCAGCGCGTTCGTAAAACAAT
GGCCTCTGGTTTTCCAGCTCGGGT -> GCCTCTGGTTTTCCAGCTCGGGTT
ACATGACTCACCGGTCCATTCACC -> CATGACTCACCGGTCCATTCACCT
CAATTGAGTTATACACGCAGTGGG -> AATTGAGTTATACACGCAGTGGGT
TAGCGCCCCCTAAATGATGACCTA -> AGCGCCCCCTAAATGATGACCTAT
TCTATAGCGCCCCCTAAATGATGA -> CTATAGCGCCCCCTAAATGATGAC
AGAGCCCTCATTAACGCGCGGCCT -> GAGCCCTCATTAACGCGCGGCCTC
CTCAAGGCCTGTAGTAGGAAGGCT -> TCAAGGCCTGTAGTAGGAAGGCTA
TCTAGCAAGAACTGAGGCGAGACT -> CTAGCAAGAACTGAGGCGAGACTG
AATCACTGCTAGTAGTAACAAGTA -> ATCACTGCTAGTAGTAACAAGTAC
CAAGTAGCAGGCTGTTGAGCAATA -> AAGTAGCAGGCTGTTGAGCAATAG
CTCTGATCTGACTTTAGCCGTGGT -> TCTGATCTGACTTTAGCCGTGGTC
ACTACCGATTAATAACAGGGGTTA -> CTACCGATTAATAACAGGGGTTAC
TTTCAATCAAAGAGCCCTCATTAA -> TTCAATCAAAGAGCCCTCATTAAC
TTCTGGTCTTGGAGCGGCAAGATC -> TCTGGTCTTGGAGCGGCAAGATCA
ATGCCGAGCGTACGTCAAAGGCAA -> TGCCGAGCGTACGTCAAAGGCAAA
TGCGATTTTGTCAGCAGCACAACT -> GCGATTTTGTCAGCAGCACAACTA
GTTTATGTCGTGGGTAGCGTAACG -> TTTATGTCGTGGGTAGCGTAACGG
CCACTTATTTAAGACTACCGATTA -> CACTTATTTAAGACTACCGATTAA
GAACAGTGGGGTGCAGAACGGCAT -> AACAGTGGGGTGCAGAACGGCATT
GTAACAAGTACGACTGGGCGGCTC -> TAACAAGTACGACTGGGCGGCTCG
GAACGGGCGCACCCCTATACTCAC -> AACGGGCGCACCCCTATACTCACA
AGGCCTTTAACTCGTAACAGCGAT -> GGCCTTTAACTCGTAACAGCGATA
GGGAATTATGCAATTTGACTTATT -> GGAATTATGCAATTTGACTTATTC
GGAGCGTATGGACATGAATGACCC -> GAGCGTATGGACATGAATGACCCT
CACTATTACCGCGCATCTTGATGA -> ACTATTACCGCGCATCTTGATGAG
TAACTCTTTCTGCGTTAGACAGCG -> AACTCTTTCTGCGTTAGACAGCGT
ATAGTTGGAACCAGTATATCGAGG -> TAGTTGGAACCAGTATATCGAGGG
GAGCACGTCGGTCTTGTGAATCGC -> AGCACGTCGGTCTTGTGAATCGCT
CAACATTAAGACTATGTATTTAGA -> AACATTAAGACTATGTATTTAGAG
TTATGCTGGATCGTAAATCCTAAT -> TATGCTGGATCGTAAATCCTAATC
TGCGGGGCATGTCGAGTATCATTC -> GCGGGGCATGTCGAGTATCATTCA
GACAGAATTCTGGTCTTGGAGCGG -> ACAGAATTCTGGTCTTGGAGCGGC
TATAGTTGGAACCAGTATATCGAG -> ATAGTTGGAACCAGTATATCGAGG
GCGGCAAGATCAATATGCAATGCA -> CGGCAAGATCAATATGCAATGCAG
CGATCACCTAACGCTATGACTGGC -> GATCACCTAACGCTATGACTGGCT
AGCGGCAAGATCAATATGCAATGC -> GCGGCAAGATCAATATGCAATGCA
GGTCCACTTCTTTAGTAAAGACCT -> GTCCACTTCTTTAGTAAAGACCTA
GCAATTGATATTTTATTAGTTGAC -> CAATTGATATTTTATTAGTTGACA
TTCAATGTCGTGGGGACTAGGACG -> TCAATGTCGTGGGGACTAGGACGG
TCTCTAGCAAGAACTGAGGCGAGA -> CTCTAGCAAGAACTGAGGCGAGAC
ATTAATATTGGACGCGCAGGGATT -> TTAATATTGGACGCGCAGGGATTG
ACGCGCGGCCTCGGCATTCTCAAT -> CGCGCGGCCTCGGCATTCTCAATC
GCGCACCCCTATACTCACAACATT -> CGCACCCCTATACTCACAACATTA
CGAGACTGCATGACATCATCCCGA -> GAGACTGCATGACATCATCCCGAG
GAACACGCATAAGAGGAAGGCACT -> AACACGCATAAGAGGAAGGCACTA
GCGTGTTAGCCAAAGTAGTTGGGA -> CGTGTTAGCCAAAGTAGTTGGGAG
AACTTTGTGCTTGCGACCCCTTAC -> ACTTTGTGCTTGCGACCCCTTACC
TGTTATGAACCGCAGTACTAACAA -> GTTATGAACCGCAGTACTAACAAT
GTATGGACATGAATGACCCTAACT -> TATGGACATGAATGACCCTAACTA
TGGCTAGGCACTATTACCGCGCAT -> GGCTAGGCACTATTACCGCGCATC
ACTTATTCATCAGTAACTTTGTGC -> CTTATTCATCAGTAACTTTGTGCT
GGTGAGACATCGAAAGTCAGCCGA -> GTGAGACATCGAAAGTCAGCCGAA
TGCCATGGAGCGTATGGACATGAA -> GCCATGGAGCGTATGGACATGAAT
AAACGCTAAACTGTGGGGCCTCTG -> AACGCTAAACTGTGGGGCCTCTGG
ACGACTGGGCGGCTCGGTGCAATT -> CGACTGGGCGGCTCGGTGCAATTC
AAGGCCTGTAGTAGGAAGGCTAAC -> AGGCCTGTAGTAGGAAGGCTAACA
CACCAAACCGGTGGAACACGCATA -> ACCAAACCGGTGGAACACGCATAA
GGGGTGCAGAACGGCATTCGCAAT -> GGGTGCAGAACGGCATTCGCAATT
ACTCTTAGATTTCGATTGGAGTTG -> CTCTTAGATTTCGATTGGAGTTGG
CGCATCTTGATGAGCCCCCGATCA -> GCATCTTGATGAGCCCCCGATCAC
TAGGACGGAATCGACGACGAGAGG -> AGGACGGAATCGACGACGAGAGGC
ACGGAATCGACGACGAGAGGCGTG -> CGGAATCGACGACGAGAGGCGTGC
TTCATTGGCGGAACAGTGGGGTGC -> TCATTGGCGGAACAGTGGGGTGCA
TCGATTGGAGTTGGGACCGCCCAC -> CGATTGGAGTTGGGACCGCCCACA
TTTAGAGTTGAAACTCTTAGATTT -> TTAGAGTTGAAACTCTTAGATTTC
AACAGGGGTTACAGTAGAGGGGCT -> ACAGGGGTTACAGTAGAGGGGCTA
AACGCGTCTCGCTCAGTTTCCCAC -> ACGCGTCTCGCTCAGTTTCCCACT
GTTAGCCAAAGTAGTTGGGAGTGG -> TTAGCCAAAGTAGTTGGGAGTGGT
GGGAGTGGTTGGGTAAGTGTGGAG -> GGAGTGGTTGGGTAAGTGTGGAGA
GTGTTACTGGGAGGTAATAAAACA -> TGTTACTGGGAGGTAATAAAACAG
ACATTATCCTTTCTCGTTGCTGCC -> CATTATCCTTTCTCGTTGCTGCCA
ATGTAACTCTTTCTGCGTTAGACA -> TGTAACTCTTTCTGCGTTAGACAG
CTGTTGAGCAATAGATTGTGACGT -> TGTTGAGCAATAGATTGTGACGTT
GATTGTGACGTTATTAGTCATCTG -> ATTGTGACGTTATTAGTCATCTGG
CTAAATGATGACCTATATGTAACT -> TAAATGATGACCTATATGTAACTC
GTAATTGTCTAGCGAACCATCCTC -> TAATTGTCTAGCGAACCATCCTCA
TTTGTAATTTGGGGTGGCACATGC -> TTGTAATTTGGGGTGGCACATGCT
TATACACGCAGTGGGTGAGACATC -> ATACACGCAGTGGGTGAGACATCG
GATCAATATGCAATGCAGGGCCTT -> ATCAATATGCAATGCAGGGCCTTG
ACTCACAACATTAAGACTATGTAT -> CTCACAACATTAAGACTATGTATT
CTGACTTTAGCCGTGGTCCACTTC -> TGACTTTAGCCGTGGTCCACTTCT
TTCCAGCTCGGGTTGATTGATTGC -> TCCAGCTCGGGTTGATTGATTGCA
TTAGTTGACAAGGTGTTGGTCTTT -> TAGTTGACAAGGTGTTGGTCTTTT
CGTGCCTTGGCTAACGCGTCTCGC -> GTGCCTTGGCTAACGCGTCTCGCT
GTTCATAAAAAACGCTAAACTGTG -> TTCATAAAAAACGCTAAACTGTGG
TATGTACGACGGCCACATTCGAAA -> ATGTACGACGGCCACATTCGAAAG
AATTGAGTTATACACGCAGTGGGT -> ATTGAGTTATACACGCAGTGGGTG
GGCCTTGGCTAGGCACTATTACCG -> GCCTTGGCTAGGCACTATTACCGC
CCAGCTCGGGTTGATTGATTGCAT -> CAGCTCGGGTTGATTGATTGCATA
TACTTTGAGGGGGATTCCTCATTA -> ACTTTGAGGGGGATTCCTCATTAT
GATAATGGCTCTGATCTGACTTTA -> ATAATGGCTCTGATCTGACTTTAG
GATTGGAGTTGGGACCGCCCACAG -> ATTGGAGTTGGGACCGCCCACAGA
CATCTGGTTGTGTTACTGGGAGGT -> ATCTGGTTGTGTTACTGGGAGGTA
CCGGATTAGTAATTGTCTAGCGAA -> CGGATTAGTAATTGTCTAGCGAAC
TAAATTCAGATTCGACCGGATTAG -> AAATTCAGATTCGACCGGATTAGT
GGTCTTGGAGCGGCAAGATCAATA -> GTCTTGGAGCGGCAAGATCAATAT
CGGCATTCGCAATTGATATTTTAT -> GGCATTCGCAATTGATATTTTATT
CTAACGCGTCTCGCTCAGTTTCCC -> TAACGCGTCTCGCTCAGTTTCCCA
TGAGACATCGAAAGTCAGCCGAAC -> GAGACATCGAAAGTCAGCCGAACG
GTACATTCTGTTCATAAAAAACGC -> TACATTCTGTTCATAAAAAACGCT
TTACTGGGAGGTAATAAAACAGAC -> TACTGGGAGGTAATAAAACAGACA
GGTGGCACATGCTTAGTCGCACAA -> GTGGCACATGCTTAGTCGCACAAC
CAATTTCAATCAAAGAGCCCTCAT -> AATTTCAATCAAAGAGCCCTCATT
ATTGGTTGCGGGGCATGTCGAGTA -> TTGGTTGCGGGGCATGTCGAGTAT
TTCGTAAAACAATCGCTCAACATT -> TCGTAAAACAATCGCTCAACATTA
TTGGACGCGCAGGGATTGGTTGCG -> TGGACGCGCAGGGATTGGTTGCGG
TTCAATCAAAGAGCCCTCATTAAC -> TCAATCAAAGAGCCCTCATTAACG
CGTTATGCTGGATCGTAAATCCTA -> GTTATGCTGGATCGTAAATCCTAA
GAGGGGCCCGACTCATAAAGGCAG -> AGGGGCCCGACTCATAAAGGCAGG
GAGTGGTTGGGTAAGTGTGGAGAC -> AGTGGTTGGGTAAGTGTGGAGACA
ATAAAGGCAGGTGTACTAAGGCGT -> TAAAGGCAGGTGTACTAAGGCGTG
TGAGCAATAGATTGTGACGTTATT -> GAGCAATAGATTGTGACGTTATTA
TCATCCTCAGGTTGTGGGGTCACC -> CATCCTCAGGTTGTGGGGTCACCT
AGCGCGTTCGTAAAACAATCGCTC -> GCGCGTTCGTAAAACAATCGCTCA
GAAAGTCAGCCGAACGGCAACCAC -> AAAGTCAGCCGAACGGCAACCACC
CATTATAGTTGGAACCAGTATATC -> ATTATAGTTGGAACCAGTATATCG
AAGGGTCCACGAGAACGGGCGCAC -> AGGGTCCACGAGAACGGGCGCACC
CTCAACATTACAATGACAGAATTC -> TCAACATTACAATGACAGAATTCT
TAAGGCGTGTTAGCCAAAGTAGTT -> AAGGCGTGTTAGCCAAAGTAGTTG
ACATTCGAAAGAAGCTAAATTCAG -> CATTCGAAAGAAGCTAAATTCAGA
CGAAGGACACGACGAGCACGTCGG -> GAAGGACACGACGAGCACGTCGGT
ATTTAAGACTACCGATTAATAACA -> TTTAAGACTACCGATTAATAACAG
CAGGTGTACTAAGGCGTGTTAGCC -> AGGTGTACTAAGGCGTGTTAGCCA
TTCTCGTTGCTGCCATGGAGCGTA -> TCTCGTTGCTGCCATGGAGCGTAT
TCAACGTATTCCTTCTAAAGCTGA -> CAACGTATTCCTTCTAAAGCTGAG
CTCCCTCCTCCGGGGCTAGGCATC -> TCCCTCCTCCGGGGCTAGGCATCC
GGATCGTAAATCCTAATCCTATTA -> GATCGTAAATCCTAATCCTATTAG
GCTAGGCATCCTTGCCCGGAATGC -> CTAGGCATCCTTGCCCGGAATGCC
GACCTATTTGTAATTTGGGGTGGC -> ACCTATTTGTAATTTGGGGTGGCA
GTGCTTGCGACCCCTTACCAATCT -> TGCTTGCGACCCCTTACCAATCTA
CGGCCTCGGCATTCTCAATCCAGA -> GGCCTCGGCATTCTCAATCCAGAA
TCGGTGCAATTCGTTTATGTCGTG -> CGGTGCAATTCGTTTATGTCGTGG
ATAGCTTCGAACGGGAATCACTGC -> TAGCTTCGAACGGGAATCACTGCT
AGCCAAAGTAGTTGGGAGTGGTTG -> GCCAAAGTAGTTGGGAGTGGTTGG
ACATTAAGACTATGTATTTAGAGT -> CATTAAGACTATGTATTTAGAGTT
AATTCAGATTCGACCGGATTAGTA -> ATTCAGATTCGACCGGATTAGTAA
TATGCGGTGCAGTAACTCGCGTTC -> ATGCGGTGCAGTAACTCGCGTTCG
TGACCCTAACTACAGCTCCCGCAG -> GACCCTAACTACAGCTCCCGCAGG
ACCTATATGTAACTCTTTCTGCGT -> CCTATATGTAACTCTTTCTGCGTT
TTGATGAGCCCCCGATCACCTAAC -> TGATGAGCCCCCGATCACCTAACG
CCTCATTAACGCGCGGCCTCGGCA -> CTCATTAACGCGCGGCCTCGGCAT
GCATCTTGATGAGCCCCCGATCAC -> CATCTTGATGAGCCCCCGATCACC
CTACGAAGGACACGACGAGCACGT -> TACGAAGGACACGACGAGCACGTC
GGTCTTGTGAATCGCTGTTATGAA -> GTCTTGTGAATCGCTGTTATGAAC
ATGTCGTGGGGACTAGGACGGAAT -> TGTCGTGGGGACTAGGACGGAATC
TCCTCATAGCAAGGATATAACCCC -> CCTCATAGCAAGGATATAACCCCA
TCGTAAATCCTAATCCTATTAGCC -> CGTAAATCCTAATCCTATTAGCCC
GTAAATCCTAATCCTATTAGCCCA -> TAAATCCTAATCCTATTAGCCCAG
GGAGTTGGGACCGCCCACAGACAC -> GAGTTGGGACCGCCCACAGACACA
ACTCCGGCCACCAAACCGGTGGAA -> CTCCGGCCACCAAACCGGTGGAAC
AGTCAGCCGAACGGCAACCACCTT -> GTCAGCCGAACGGCAACCACCTTT
GCCTTTAACTCGTAACAGCGATAA -> CCTTTAACTCGTAACAGCGATAAT
CAGTTTCCCACTTATTTAAGACTA -> AGTTTCCCACTTATTTAAGACTAC
CGGGTTGATTGATTGCATACTAGG -> GGGTTGATTGATTGCATACTAGGT
CCACATTCGAAAGAAGCTAAATTC -> CACATTCGAAAGAAGCTAAATTCA
AAAACAATCGCTCAACATTACAAT -> AAACAATCGCTCAACATTACAATG
AGAAGCTAAATTCAGATTCGACCG -> GAAGCTAAATTCAGATTCGACCGG
ACATTCTGTTCATAAAAAACGCTA -> CATTCTGTTCATAAAAAACGCTAA
GGCTGTTGAGCAATAGATTGTGAC -> GCTGTTGAGCAATAGATTGTGACG
GTTGTGGGGTCACCTTTAACAGTG -> TTGTGGGGTCACCTTTAACAGTGT
GTCTCGCTCAGTTTCCCACTTATT -> TCTCGCTCAGTTTCCCACTTATTT
CCCCTAAATGATGACCTATATGTA -> CCCTAAATGATGACCTATATGTAA
CCCTCATTAACGCGCGGCCTCGGC -> CCTCATTAACGCGCGGCCTCGGCA
TCTGCGTTAGACAGCGTTATGCTG -> CTGCGTTAGACAGCGTTATGCTGG
AGGCACTATTACCGCGCATCTTGA -> GGCACTATTACCGCGCATCTTGAT
CTAGCAAGAACTGAGGCGAGACTG -> TAGCAAGAACTGAGGCGAGACTGC
ATTCGTTTATGTCGTGGGTAGCGT -> TTCGTTTATGTCGTGGGTAGCGTA
AGTAACTCCGGCCACCAAACCGGT -> GTAACTCCGGCCACCAAACCGGTG
CCCTCAAGGCCTGTAGTAGGAAGG -> CCTCAAGGCCTGTAGTAGGAAGGC
CCTCAAGGCCTGTAGTAGGAAGGC -> CTCAAGGCCTGTAGTAGGAAGGCT
CGGTGCAATTCGTTTATGTCGTGG -> GGTGCAATTCGTTTATGTCGTGGG
ATGCAATGCAGGGCCTTGGCTAGG -> TGCAATGCAGGGCCTTGGCTAGGC
CGCAGTACTAACAATTGAGTTATA -> GCAGTACTAACAATTGAGTTATAC
TTAACAGTGTACATTCTGTTCATA -> TAACAGTGTACATTCTGTTCATAA
CGGGGCTAGGCATCCTTGCCCGGA -> GGGGCTAGGCATCCTTGCCCGGAA
GGAACCAGTATATCGAGGGAATTA -> GAACCAGTATATCGAGGGAATTAT
AATTCTGGTCTTGGAGCGGCAAGA -> ATTCTGGTCTTGGAGCGGCAAGAT
CATTAAGACTATGTATTTAGAGTT -> ATTAAGACTATGTATTTAGAGTTG
GCTCTGATCTGACTTTAGCCGTGG -> CTCTGATCTGACTTTAGCCGTGGT
TAGCCGTGGTCCACTTCTTTAGTA -> AGCCGTGGTCCACTTCTTTAGTAA
TGCCTGAATATGTACGACGGCCAC -> GCCTGAATATGTACGACGGCCACA
CTTTGTGCTTGCGACCCCTTACCA -> TTTGTGCTTGCGACCCCTTACCAA
GTACGACGGCCACATTCGAAAGAA -> TACGACGGCCACATTCGAAAGAAG
CTTCTTTAGTAAAGACCTATTTGT -> TTCTTTAGTAAAGACCTATTTGTA
CATAGAGTAACTCCGGCCACCAAA -> ATAGAGTAACTCCGGCCACCAAAC
CCCAGCGGACAAAGGGTCCACGAG -> CCAGCGGACAAAGGGTCCACGAGA
TAGAGTAACTCCGGCCACCAAACC -> AGAGTAACTCCGGCCACCAAACCG
GAGGACTAGATGCCGAGCGTACGT -> AGGACTAGATGCCGAGCGTACGTC
GACTACCGATTAATAACAGGGGTT -> ACTACCGATTAATAACAGGGGTTA
AGTATCATTCAAAAGTTGTCAACG -> GTATCATTCAAAAGTTGTCAACGT
ATCATCCCGAGGACTAGATGCCGA -> TCATCCCGAGGACTAGATGCCGAG
GGTATTTATCCTCCCCTACGAAGG -> GTATTTATCCTCCCCTACGAAGGA
TAGTAACAAGTACGACTGGGCGGC -> AGTAACAAGTACGACTGGGCGGCT
TGTCGTGGGTAGCGTAACGGCCTT -> GTCGTGGGTAGCGTAACGGCCTTC
CGTAACGGCCTTCAATGTCGTGGG -> GTAACGGCCTTCAATGTCGTGGGG
AAGTGATCAACCCGCTACCAACAA -> AGTGATCAACCCGCTACCAACAAA
GCAGGGCCTTGGCTAGGCACTATT -> CAGGGCCTTGGCTAGGCACTATTA
TTGTCAACGTATTCCTTCTAAAGC -> TGTCAACGTATTCCTTCTAAAGCT
TGTGTTACTGGGAGGTAATAAAAC -> GTGTTACTGGGAGGTAATAAAACA
TGACCTATATGTAACTCTTTCTGC -> GACCTATATGTAACTCTTTCTGCG
AGAAGTGATCAACCCGCTACCAAC -> GAAGTGATCAACCCGCTACCAACA
GCAAGGATATAACCCCAGCGCGTT -> CAAGGATATAACCCCAGCGCGTTC
GACATCATCCCGAGGACTAGATGC -> ACATCATCCCGAGGACTAGATGCC
TAACATCATCCTCAGGTTGTGGGG -> AACATCATCCTCAGGTTGTGGGGT
TGCTTGCGACCCCTTACCAATCTA -> GCTTGCGACCCCTTACCAATCTAG
GAGCCCTCATTAACGCGCGGCCTC -> AGCCCTCATTAACGCGCGGCCTCG
ACCACCTTTTTCGGAGTTGGACTT -> CCACCTTTTTCGGAGTTGGACTTT
GGGTCCACGAGAACGGGCGCACCC -> GGTCCACGAGAACGGGCGCACCCC
TGGAAAATCTTGTTTTGTCAGTAT -> GGAAAATCTTGTTTTGTCAGTATA
TGCTGCCATGGAGCGTATGGACAT -> GCTGCCATGGAGCGTATGGACATG
CCGCAGTACTAACAATTGAGTTAT -> CGCAGTACTAACAATTGAGTTATA
TCAATCCAGAAGCTGCCTCAAGTA -> CAATCCAGAAGCTGCCTCAAGTAG
CGCGCGGCCTCGGCATTCTCAATC -> GCGCGGCCTCGGCATTCTCAATCC
CATGACTCACCGGTCCATTCACCT -> ATGACTCACCGGTCCATTCACCTT
GTAACTCGCGTTCGTCCTTGTCAC -> TAACTCGCGTTCGTCCTTGTCACA
TGCATGACATCATCCCGAGGACTA -> GCATGACATCATCCCGAGGACTAG
TAACCCCAGCGCGTTCGTAAAACA -> AACCCCAGCGCGTTCGTAAAACAA
CAGTGGGTGAGACATCGAAAGTCA -> AGTGGGTGAGACATCGAAAGTCAG
CACAGACACATTAAAGTAGTGCAT -> ACAGACACATTAAAGTAGTGCATA
GTGCAGAACGGCATTCGCAATTGA -> TGCAGAACGGCATTCGCAATTGAT
GCGTTAGACAGCGTTATGCTGGAT -> CGTTAGACAGCGTTATGCTGGATC
CGCATAAGAGGAAGGCACTATAGC -> GCATAAGAGGAAGGCACTATAGCT
TGTCTAGCGAACCATCCTCATAGC -> GTCTAGCGAACCATCCTCATAGCA
ATTCATCAGTAACTTTGTGCTTGC -> TTCATCAGTAACTTTGTGCTTGCG
AGGCATCCTTGCCCGGAATGCCTG -> GGCATCCTTGCCCGGAATGCCTGA
GAGCGTACGTCAAAGGCAAAGATA -> AGCGTACGTCAAAGGCAAAGATAG
ACCTTTAACAGTGTACATTCTGTT -> CCTTTAACAGTGTACATTCTGTTC
ACGTCGGTCTTGTGAATCGCTGTT -> CGTCGGTCTTGTGAATCGCTGTTA
TAATCCTATTAGCCCAGCGGACAA -> AATCCTATTAGCCCAGCGGACAAA
TTAGTCATCTGGTTGTGTTACTGG -> TAGTCATCTGGTTGTGTTACTGGG
AGGCTCCCTCCTCCGGGGCTAGGC -> GGCTCCCTCCTCCGGGGCTAGGCA
CCCCCCTCAAGGCCTGTAGTAGGA -> CCCCCTCAAGGCCTGTAGTAGGAA
GGCAACCACCTTTTTCGGAGTTGG -> GCAACCACCTTTTTCGGAGTTGGA
ATGGTTGAGGGGCCCGACTCATAA -> TGGTTGAGGGGCCCGACTCATAAA
GAGACAGGCTCCCTCCTCCGGGGC -> AGACAGGCTCCCTCCTCCGGGGCT
TAGACAGCGTTATGCTGGATCGTA -> AGACAGCGTTATGCTGGATCGTAA
TACAGCTCCCGCAGGCCTTTAACT -> ACAGCTCCCGCAGGCCTTTAACTC
ACATCATCCTCAGGTTGTGGGGTC -> CATCATCCTCAGGTTGTGGGGTCA
TATAGCGCCCCCTAAATGATGACC -> ATAGCGCCCCCTAAATGATGACCT
ATTTATCCTCCCCTACGAAGGACA -> TTTATCCTCCCCTACGAAGGACAC
GGGCGGCTCGGTGCAATTCGTTTA -> GGCGGCTCGGTGCAATTCGTTTAT
GTACTAAGGCGTGTTAGCCAAAGT -> TACTAAGGCGTGTTAGCCAAAGTA
TAGAGGGGCTATTCTCTAGCAAGA -> AGAGGGGCTATTCTCTAGCAAGAA
CCTTTAACTCGTAACAGCGATAAT -> CTTTAACTCGTAACAGCGATAATG
ACCTTTTTCGGAGTTGGACTTTTC -> CCTTTTTCGGAGTTGGACTTTTCC
GGCTCGGTGCAATTCGTTTATGTC -> GCTCGGTGCAATTCGTTTATGTCG
AAGAGCCCTCATTAACGCGCGGCC -> AGAGCCCTCATTAACGCGCGGCCT
TAACAGCGATAATGGCTCTGATCT -> AACAGCGATAATGGCTCTGATCTG
GGATTCCTCATTATAGTTGGAACC -> GATTCCTCATTATAGTTGGAACCA
TATCCTCCCCTACGAAGGACACGA -> ATCCTCCCCTACGAAGGACACGAC
GAACGGCATTCGCAATTGATATTT -> AACGGCATTCGCAATTGATATTTT
CCTTGTCACATGACTCACCGGTCC -> CTTGTCACATGACTCACCGGTCCA
GGGGGATTCCTCATTATAGTTGGA -> GGGGATTCCTCATTATAGTTGGAA
TCGCTCAACATTACAATGACAGAA -> CGCTCAACATTACAATGACAGAAT
AGCTCGGGTTGATTGATTGCATAC -> GCTCGGGTTGATTGATTGCATACT
GAGTTGAAACTCTTAGATTTCGAT -> AGTTGAAACTCTTAGATTTCGATT
TGGTTGTGTTACTGGGAGGTAATA -> GGTTGTGTTACTGGGAGGTAATAA
TCAAGGCCTGTAGTAGGAAGGCTA -> CAAGGCCTGTAGTAGGAAGGCTAA
CACAACTAAGGTATTTATCCTCCC -> ACAACTAAGGTATTTATCCTCCCC
CTTTAGTAAAGACCTATTTGTAAT -> TTTAGTAAAGACCTATTTGTAATT
CGACCGGATTAGTAATTGTCTAGC -> GACCGGATTAGTAATTGTCTAGCG
CCTGAATATGTACGACGGCCACAT -> CTGAATATGTACGACGGCCACATT
CCCCAGCGCGTTCGTAAAACAATC -> CCCAGCGCGTTCGTAAAACAATCG
TGGTTGAGGGGCCCGACTCATAAA -> GGTTGAGGGGCCCGACTCATAAAG
AGTAAAGACCTATTTGTAATTTGG -> GTAAAGACCTATTTGTAATTTGGG
TTCATAAAAAACGCTAAACTGTGG -> TCATAAAAAACGCTAAACTGTGGG
TGATTGATTGCATACTAGGTGCTC -> GATTGATTGCATACTAGGTGCTCT
TGTTCATAAAAAACGCTAAACTGT -> GTTCATAAAAAACGCTAAACTGTG
GGAGCGGCAAGATCAATATGCAAT -> GAGCGGCAAGATCAATATGCAATG
CCTCCTCCGGGGCTAGGCATCCTT -> CTCCTCCGGGGCTAGGCATCCTTG
TTGTAATTTGGGGTGGCACATGCT -> TGTAATTTGGGGTGGCACATGCTT
CCACAGACACATTAAAGTAGTGCA -> CACAGACACATTAAAGTAGTGCAT
TGTCAACGTATTCCTTCTAAAGCT -> GTCAACGTATTCCTTCTAAAGCTG
GTGACGTTATTAGTCATCTGGTTG -> TGACGTTATTAGTCATCTGGTTGT
AGACTACCGATTAATAACAGGGGT -> GACTACCGATTAATAACAGGGGTT
AACTCTTTCTGCGTTAGACAGCGT -> ACTCTTTCTGCGTTAGACAGCGTT
TAGGCACTATTACCGCGCATCTTG -> AGGCACTATTACCGCGCATCTTGA
ACTACAGCTCCCGCAGGCCTTTAA -> CTACAGCTCCCGCAGGCCTTTAAC
ATAGATGGTTGAGGGGCCCGACTC -> TAGATGGTTGAGGGGCCCGACTCA
TCCTATTAGCCCAGCGGACAAAGG -> CCTATTAGCCCAGCGGACAAAGGG
GGGGCCCGACTCATAAAGGCAGGT -> GGGCCCGACTCATAAAGGCAGGTG
AGGGAATTATGCAATTTGACTTAT -> GGGAATTATGCAATTTGACTTATT
AGTAGTTGGGAGTGGTTGGGTAAG -> GTAGTTGGGAGTGGTTGGGTAAGT
GGATATAACCCCAGCGCGTTCGTA -> GATATAACCCCAGCGCGTTCGTAA
GGCTATTCTCTAGCAAGAACTGAG -> GCTATTCTCTAGCAAGAACTGAGG
TTCGGAGTTGGACTTTTCCCCCCC -> TCGGAGTTGGACTTTTCCCCCCCT
AACTGCGATTTTGTCAGCAGCACA -> ACTGCGATTTTGTCAGCAGCACAA
AGGCCTGTAGTAGGAAGGCTAACA -> GGCCTGTAGTAGGAAGGCTAACAT
TGATCAACCCGCTACCAACAAATT -> GATCAACCCGCTACCAACAAATTA
GCGCAGGGATTGGTTGCGGGGCAT -> CGCAGGGATTGGTTGCGGGGCATG
GTAATTTGGGGTGGCACATGCTTA -> TAATTTGGGGTGGCACATGCTTAG
AGACACATTAAAGTAGTGCATAGA -> GACACATTAAAGTAGTGCATAGAG
TAAAACAATCGCTCAACATTACAA -> AAAACAATCGCTCAACATTACAAT
GCCTCTGGTTTTCCAGCTCGGGTT -> CCTCTGGTTTTCCAGCTCGGGTTG
CTGCCATGGAGCGTATGGACATGA -> TGCCATGGAGCGTATGGACATGAA
TTGGCTAGGCACTATTACCGCGCA -> TGGCTAGGCACTATTACCGCGCAT
GCTAACATCATCCTCAGGTTGTGG -> CTAACATCATCCTCAGGTTGTGGG
GGCAAGATCAATATGCAATGCAGG -> GCAAGATCAATATGCAATGCAGGG
TCTCGTTGCTGCCATGGAGCGTAT -> CTCGTTGCTGCCATGGAGCGTATG
GGGACCGCCCACAGACACATTAAA -> GGACCGCCCACAGACACATTAAAG
GATACTTTGAGGGGGATTCCTCAT -> ATACTTTGAGGGGGATTCCTCATT
TTAAGACTATGTATTTAGAGTTGA -> TAAGACTATGTATTTAGAGTTGAA
TGATATTTTATTAGTTGACAAGGT -> GATATTTTATTAGTTGACAAGGTG
TGAACCGCAGTACTAACAATTGAG -> GAACCGCAGTACTAACAATTGAGT
TGCATACTAGGTGCTCTCTATAGC -> GCATACTAGGTGCTCTCTATAGCG
CGTGGTCCACTTCTTTAGTAAAGA -> GTGGTCCACTTCTTTAGTAAAGAC
TTTGTGCTTGCGACCCCTTACCAA -> TTGTGCTTGCGACCCCTTACCAAT
AGCTTCGAACGGGAATCACTGCTA -> GCTTCGAACGGGAATCACTGCTAG
GTCAGCAGCACAACTAAGGTATTT -> TCAGCAGCACAACTAAGGTATTTA
AAAGCTGAGCCTATTCAGAGGATG -> AAGCTGAGCCTATTCAGAGGATGC
TTCGTTTATGTCGTGGGTAGCGTA -> TCGTTTATGTCGTGGGTAGCGTAA
ACCCGCTACCAACAAATTAATATT -> CCCGCTACCAACAAATTAATATTG
GTTTTGTCAGTATATCAATTTCAA -> TTTTGTCAGTATATCAATTTCAAT
AAAGACCTATTTGTAATTTGGGGT -> AAGACCTATTTGTAATTTGGGGTG
GTTATTAGTCATCTGGTTGTGTTA -> TTATTAGTCATCTGGTTGTGTTAC
ATTTTATTAGTTGACAAGGTGTTG -> TTTTATTAGTTGACAAGGTGTTGG
AACCAGTATATCGAGGGAATTATG -> ACCAGTATATCGAGGGAATTATGC
ATCCTCAGGTTGTGGGGTCACCTT -> TCCTCAGGTTGTGGGGTCACCTTT
TTGAAACTCTTAGATTTCGATTGG -> TGAAACTCTTAGATTTCGATTGGA
TAACTTTGTGCTTGCGACCCCTTA -> AACTTTGTGCTTGCGACCCCTTAC
ATGACCTATATGTAACTCTTTCTG -> TGACCTATATGTAACTCTTTCTGC
TAACGGCCTTCAATGTCGTGGGGA -> AACGGCCTTCAATGTCGTGGGGAC
CTAGGTGCTCTCTATAGCGCCCCC -> TAGGTGCTCTCTATAGCGCCCCCT
GCACATGCTTAGTCGCACAACTGC -> CACATGCTTAGTCGCACAACTGCG
TAATAAAACAGACATTATCCTTTC -> AATAAAACAGACATTATCCTTTCT
CGGTCCATTCACCTTGTCGCGCTT -> GGTCCATTCACCTTGTCGCGCTTT
GTTGCTGCCATGGAGCGTATGGAC -> TTGCTGCCATGGAGCGTATGGACA
AAATTCAGATTCGACCGGATTAGT -> AATTCAGATTCGACCGGATTAGTA
CGAGGACTAGATGCCGAGCGTACG -> GAGGACTAGATGCCGAGCGTACGT
GACCCTAACTACAGCTCCCGCAGG -> ACCCTAACTACAGCTCCCGCAGGC
GTGGAGACAGGCTCCCTCCTCCGG -> TGGAGACAGGCTCCCTCCTCCGGG
TAGTAGTAACAAGTACGACTGGGC -> AGTAGTAACAAGTACGACTGGGCG
TTTCGGAGTTGGACTTTTCCCCCC -> TTCGGAGTTGGACTTTTCCCCCCC
GTGGAACACGCATAAGAGGAAGGC -> TGGAACACGCATAAGAGGAAGGCA
CGATTTTGTCAGCAGCACAACTAA -> GATTTTGTCAGCAGCACAACTAAG
GTCGTGGGGACTAGGACGGAATCG -> TCGTGGGGACTAGGACGGAATCGA
CTGCTAGTAGTAACAAGTACGACT -> TGCTAGTAGTAACAAGTACGACTG
AGACTGCATGACATCATCCCGAGG -> GACTGCATGACATCATCCCGAGGA
TTTTATTAGTTGACAAGGTGTTGG -> TTTATTAGTTGACAAGGTGTTGGT
ACAGTGGGGTGCAGAACGGCATTC -> CAGTGGGGTGCAGAACGGCATTCG
GGTTGAGGGGCCCGACTCATAAAG -> GTTGAGGGGCCCGACTCATAAAGG
CCTTTAACAGTGTACATTCTGTTC -> CTTTAACAGTGTACATTCTGTTCA
CAAGTACGACTGGGCGGCTCGGTG -> AAGTACGACTGGGCGGCTCGGTGC
TCAAAGGCAAAGATAGATGGTTGA -> CAAAGGCAAAGATAGATGGTTGAG
TCTCAATCCAGAAGCTGCCTCAAG -> CTCAATCCAGAAGCTGCCTCAAGT
CGGATTAGTAATTGTCTAGCGAAC -> GGATTAGTAATTGTCTAGCGAACC
TCTGACTTTAGCCGTGGTCCACTT -> CTGACTTTAGCCGTGGTCCACTTC
TGACGTTATTAGTCATCTGGTTGT -> GACGTTATTAGTCATCTGGTTGTG
ATGACATCATCCCGAGGACTAGAT -> TGACATCATCCCGAGGACTAGATG
AAAGGCAAAGATAGATGGTTGAGG -> AAGGCAAAGATAGATGGTTGAGGG
TGACATCATCCCGAGGACTAGATG -> GACATCATCCCGAGGACTAGATGC
TTATACACGCAGTGGGTGAGACAT -> TATACACGCAGTGGGTGAGACATC
ATTGGAGTTGGGACCGCCCACAGA -> TTGGAGTTGGGACCGCCCACAGAC
TTAGTCGCACAACTGCGATTTTGT -> TAGTCGCACAACTGCGATTTTGTC
TATCAATTTCAATCAAAGAGCCCT -> ATCAATTTCAATCAAAGAGCCCTC
TTGGAACCAGTATATCGAGGGAAT -> TGGAACCAGTATATCGAGGGAATT
ATTAGTTGACAAGGTGTTGGTCTT -> TTAGTTGACAAGGTGTTGGTCTTT
TCGTGGGGACTAGGACGGAATCGA -> CGTGGGGACTAGGACGGAATCGAC
TGTCGAGTATCATTCAAAAGTTGT -> GTCGAGTATCATTCAAAAGTTGTC
ATAAGAGGAAGGCACTATAGCTTC -> TAAGAGGAAGGCACTATAGCTTCG
AAGGCTAACATCATCCTCAGGTTG -> AGGCTAACATCATCCTCAGGTTGT
CTATATGTAACTCTTTCTGCGTTA -> TATATGTAACTCTTTCTGCGTTAG
TTGGGACCGCCCACAGACACATTA -> TGGGACCGCCCACAGACACATTAA
AATCGCTCAACATTACAATGACAG -> ATCGCTCAACATTACAATGACAGA
CGTCGGTCTTGTGAATCGCTGTTA -> GTCGGTCTTGTGAATCGCTGTTAT
TGGTTTTCCAGCTCGGGTTGATTG -> GGTTTTCCAGCTCGGGTTGATTGA
AAGGCAGGTGTACTAAGGCGTGTT -> AGGCAGGTGTACTAAGGCGTGTTA
TATATGTAACTCTTTCTGCGTTAG -> ATATGTAACTCTTTCTGCGTTAGA
GCGTGCCGTGCCTTGGCTAACGCG -> CGTGCCGTGCCTTGGCTAACGCGT
CAGTGGGGTGCAGAACGGCATTCG -> AGTGGGGTGCAGAACGGCATTCGC
CATTCGAAAGAAGCTAAATTCAGA -> ATTCGAAAGAAGCTAAATTCAGAT
TACCAACAAATTAATATTGGACGC -> ACCAACAAATTAATATTGGACGCG
TTACAGTAGAGGGGCTATTCTCTA -> TACAGTAGAGGGGCTATTCTCTAG
GTATTCCTTCTAAAGCTGAGCCTA -> TATTCCTTCTAAAGCTGAGCCTAT
AGACATTATCCTTTCTCGTTGCTG -> GACATTATCCTTTCTCGTTGCTGC
TACTAGGTGCTCTCTATAGCGCCC -> ACTAGGTGCTCTCTATAGCGCCCC
CTCTAGCAAGAACTGAGGCGAGAC -> TCTAGCAAGAACTGAGGCGAGACT
AACGGCCTTCAATGTCGTGGGGAC -> ACGGCCTTCAATGTCGTGGGGACT
ATTCTCAATCCAGAAGCTGCCTCA -> TTCTCAATCCAGAAGCTGCCTCAA
CCCCCCCTCAAGGCCTGTAGTAGG -> CCCCCCTCAAGGCCTGTAGTAGGA
GCAGTACTAACAATTGAGTTATAC -> CAGTACTAACAATTGAGTTATACA
TTTCTGCGTTAGACAGCGTTATGC -> TTCTGCGTTAGACAGCGTTATGCT
CAGACATTATCCTTTCTCGTTGCT -> AGACATTATCCTTTCTCGTTGCTG
CCTTTCTCGTTGCTGCCATGGAGC -> CTTTCTCGTTGCTGCCATGGAGCG
TAAACTGTGGGGCCTCTGGTTTTC -> AAACTGTGGGGCCTCTGGTTTTCC
TCAAAAGTTGTCAACGTATTCCTT -> CAAAAGTTGTCAACGTATTCCTTC
TTAAGACTACCGATTAATAACAGG -> TAAGACTACCGATTAATAACAGGG
ACCCCAGCGCGTTCGTAAAACAAT -> CCCCAGCGCGTTCGTAAAACAATC
GCGGACAAAGGGTCCACGAGAACG -> CGGACAAAGGGTCCACGAGAACGG
AGTTGGAACCAGTATATCGAGGGA -> GTTGGAACCAGTATATCGAGGGAA
GGTTACAGTAGAGGGGCTATTCTC -> GTTACAGTAGAGGGGCTATTCTCT
GACGTTATTAGTCATCTGGTTGTG -> ACGTTATTAGTCATCTGGTTGTGT
CTGTGGGGCCTCTGGTTTTCCAGC -> TGTGGGGCCTCTGGTTTTCCAGCT
TTATGAACCGCAGTACTAACAATT -> TATGAACCGCAGTACTAACAATTG
GATATTTTATTAGTTGACAAGGTG -> ATATTTTATTAGTTGACAAGGTGT
ACAAATTAATATTGGACGCGCAGG -> CAAATTAATATTGGACGCGCAGGG
ACTGGCTTCATTGGCGGAACAGTG -> CTGGCTTCATTGGCGGAACAGTGG
ACTATGTATTTAGAGTTGAAACTC -> CTATGTATTTAGAGTTGAAACTCT
ATAACAGGGGTTACAGTAGAGGGG -> TAACAGGGGTTACAGTAGAGGGGC
ATCGCTCAACATTACAATGACAGA -> TCGCTCAACATTACAATGACAGAA
ACAATCGCTCAACATTACAATGAC -> CAATCGCTCAACATTACAATGACA
GGGCTAGGCATCCTTGCCCGGAAT -> GGCTAGGCATCCTTGCCCGGAATG
CTATTTGTAATTTGGGGTGGCACA -> TATTTGTAATTTGGGGTGGCACAT
CGGTGGAACACGCATAAGAGGAAG -> GGTGGAACACGCATAAGAGGAAGG
ATTGTCTAGCGAACCATCCTCATA -> TTGTCTAGCGAACCATCCTCATAG
GCTGTTATGAACCGCAGTACTAAC -> CTGTTATGAACCGCAGTACTAACA
TTCGAACGGGAATCACTGCTAGTA -> TCGAACGGGAATCACTGCTAGTAG
GTAGTTGGGAGTGGTTGGGTAAGT -> TAGTTGGGAGTGGTTGGGTAAGTG
GACGAGAGGCGTGCCGTGCCTTGG -> ACGAGAGGCGTGCCGTGCCTTGGC
ATTTCGATTGGAGTTGGGACCGCC -> TTTCGATTGGAGTTGGGACCGCCC
AAAGTAGTTGGGAGTGGTTGGGTA -> AAGTAGTTGGGAGTGGTTGGGTAA
GCGCATCTTGATGAGCCCCCGATC -> CGCATCTTGATGAGCCCCCGATCA
GCACTATAGCTTCGAACGGGAATC -> CACTATAGCTTCGAACGGGAATCA
TAACAGTGTACATTCTGTTCATAA -> AACAGTGTACATTCTGTTCATAAA
TCCTCCCCTACGAAGGACACGACG -> CCTCCCCTACGAAGGACACGACGA
AATTCGTTTATGTCGTGGGTAGCG -> ATTCGTTTATGTCGTGGGTAGCGT
GCGATAATGGCTCTGATCTGACTT -> CGATAATGGCTCTGATCTGACTTT
GGCCTGTAGTAGGAAGGCTAACAT -> GCCTGTAGTAGGAAGGCTAACATC
TTAGTAATTGTCTAGCGAACCATC -> TAGTAATTGTCTAGCGAACCATCC
ATATGCAATGCAGGGCCTTGGCTA -> TATGCAATGCAGGGCCTTGGCTAG
GGGTAAGTGTGGAGACAGGCTCCC -> GGTAAGTGTGGAGACAGGCTCCCT
TTCGACCGGATTAGTAATTGTCTA -> TCGACCGGATTAGTAATTGTCTAG
AGACAGGCTCCCTCCTCCGGGGCT -> GACAGGCTCCCTCCTCCGGGGCTA
CAAGATCAATATGCAATGCAGGGC -> AAGATCAATATGCAATGCAGGGCC
GGAATCGACGACGAGAGGCGTGCC -> GAATCGACGACGAGAGGCGTGCCG
ACGCTATGACTGGCTTCATTGGCG -> CGCTATGACTGGCTTCATTGGCGG
GAATCGACGACGAGAGGCGTGCCG -> AATCGACGACGAGAGGCGTGCCGT
GAAGTGATCAACCCGCTACCAACA -> AAGTGATCAACCCGCTACCAACAA
CGACGAGCACGTCGGTCTTGTGAA -> GACGAGCACGTCGGTCTTGTGAAT
CCATGGAGCGTATGGACATGAATG -> CATGGAGCGTATGGACATGAATGA
TGGGAGGTAATAAAACAGACATTA -> GGGAGGTAATAAAACAGACATTAT
GTGTACATTCTGTTCATAAAAAAC -> TGTACATTCTGTTCATAAAAAACG
AACAGTGGGGTGCAGAACGGCATT -> ACAGTGGGGTGCAGAACGGCATTC
TGGGGTGGCACATGCTTAGTCGCA -> GGGGTGGCACATGCTTAGTCGCAC
TTCGTCCTTGTCACATGACTCACC -> TCGTCCTTGTCACATGACTCACCG
CAGGGGTTACAGTAGAGGGGCTAT -> AGGGGTTACAGTAGAGGGGCTATT
TTTCCCACTTATTTAAGACTACCG -> TTCCCACTTATTTAAGACTACCGA
CAATAGATTGTGACGTTATTAGTC -> AATAGATTGTGACGTTATTAGTCA
GGCACTATAGCTTCGAACGGGAAT -> GCACTATAGCTTCGAACGGGAATC
CATCCTTGCCCGGAATGCCTGAAT -> ATCCTTGCCCGGAATGCCTGAATA
TATACTCACAACATTAAGACTATG -> ATACTCACAACATTAAGACTATGT
GTATCATTCAAAAGTTGTCAACGT -> TATCATTCAAAAGTTGTCAACGTA
GGCATTCTCAATCCAGAAGCTGCC -> GCATTCTCAATCCAGAAGCTGCCT
ACGACGAGAGGCGTGCCGTGCCTT -> CGACGAGAGGCGTGCCGTGCCTTG
AAGGATATAACCCCAGCGCGTTCG -> AGGATATAACCCCAGCGCGTTCGT
CTATTAGCCCAGCGGACAAAGGGT -> TATTAGCCCAGCGGACAAAGGGTC
CAGGGATTGGTTGCGGGGCATGTC -> AGGGATTGGTTGCGGGGCATGTCG
TTTATTAGTTGACAAGGTGTTGGT -> TTATTAGTTGACAAGGTGTTGGTC
AATATGCAATGCAGGGCCTTGGCT -> ATATGCAATGCAGGGCCTTGGCTA
ACTAGATGCCGAGCGTACGTCAAA -> CTAGATGCCGAGCGTACGTCAAAG
TGGCACATGCTTAGTCGCACAACT -> GGCACATGCTTAGTCGCACAACTG
TGCCTCAAGTAGCAGGCTGTTGAG -> GCCTCAAGTAGCAGGCTGTTGAGC
TATTAGTCATCTGGTTGTGTTACT -> ATTAGTCATCTGGTTGTGTTACTG
CCTTCTAAAGCTGAGCCTATTCAG -> CTTCTAAAGCTGAGCCTATTCAGA
CTTTAACAGTGTACATTCTGTTCA -> TTTAACAGTGTACATTCTGTTCAT
GGCACTATTACCGCGCATCTTGAT -> GCACTATTACCGCGCATCTTGATG
TTGAGTTATACACGCAGTGGGTGA -> TGAGTTATACACGCAGTGGGTGAG
GTCAGCCGAACGGCAACCACCTTT -> TCAGCCGAACGGCAACCACCTTTT
CTTGTTTTGTCAGTATATCAATTT -> TTGTTTTGTCAGTATATCAATTTC
TAGAGTTGAAACTCTTAGATTTCG -> AGAGTTGAAACTCTTAGATTTCGA
GATTTCGATTGGAGTTGGGACCGC -> ATTTCGATTGGAGTTGGGACCGCC
GGTGCAGTAACTCGCGTTCGTCCT -> GTGCAGTAACTCGCGTTCGTCCTT
AAGAACTGAGGCGAGACTGCATGA -> AGAACTGAGGCGAGACTGCATGAC
GTTAGACAGCGTTATGCTGGATCG -> TTAGACAGCGTTATGCTGGATCGT
AGTTGGGACCGCCCACAGACACAT -> GTTGGGACCGCCCACAGACACATT
AGATAGATGGTTGAGGGGCCCGAC -> GATAGATGGTTGAGGGGCCCGACT
TTTGAGGGGGATTCCTCATTATAG -> TTGAGGGGGATTCCTCATTATAGT
AACTGTGGGGCCTCTGGTTTTCCA -> ACTGTGGGGCCTCTGGTTTTCCAG
TGAGGGGCCCGACTCATAAAGGCA -> GAGGGGCCCGACTCATAAAGGCAG
CGTTAGACAGCGTTATGCTGGATC -> GTTAGACAGCGTTATGCTGGATCG
GTGATCAACCCGCTACCAACAAAT -> TGATCAACCCGCTACCAACAAATT
TTGTCACATGACTCACCGGTCCAT -> TGTCACATGACTCACCGGTCCATT
GAGGGGGATTCCTCATTATAGTTG -> AGGGGGATTCCTCATTATAGTTGG
ATTGCATACTAGGTGCTCTCTATA -> TTGCATACTAGGTGCTCTCTATAG
TTGGACTTTTCCCCCCCTCAAGGC -> TGGACTTTTCCCCCCCTCAAGGCC
CCGCGCATCTTGATGAGCCCCCGA -> CGCGCATCTTGATGAGCCCCCGAT
AGTGGGTGAGACATCGAAAGTCAG -> GTGGGTGAGACATCGAAAGTCAGC
AATGACCCTAACTACAGCTCCCGC -> ATGACCCTAACTACAGCTCCCGCA
AGTATATCAATTTCAATCAAAGAG -> GTATATCAATTTCAATCAAAGAGC
CTATAGCGCCCCCTAAATGATGAC -> TATAGCGCCCCCTAAATGATGACC
CGCGTTCGTCCTTGTCACATGACT -> GCGTTCGTCCTTGTCACATGACTC
CCCGACTCATAAAGGCAGGTGTAC -> CCGACTCATAAAGGCAGGTGTACT
AGTAACTCGCGTTCGTCCTTGTCA -> GTAACTCGCGTTCGTCCTTGTCAC
GGGGCTATTCTCTAGCAAGAACTG -> GGGCTATTCTCTAGCAAGAACTGA
TCTGGTTGTGTTACTGGGAGGTAA -> CTGGTTGTGTTACTGGGAGGTAAT
GCTCAACATTACAATGACAGAATT -> CTCAACATTACAATGACAGAATTC
TATATCGAGGGAATTATGCAATTT -> ATATCGAGGGAATTATGCAATTTG
ACCGGTGGAACACGCATAAGAGGA -> CCGGTGGAACACGCATAAGAGGAA
TGGTTGCGGGGCATGTCGAGTATC -> GGTTGCGGGGCATGTCGAGTATCA
ACCGCGCATCTTGATGAGCCCCCG -> CCGCGCATCTTGATGAGCCCCCGA
GTCCACTTCTTTAGTAAAGACCTA -> TCCACTTCTTTAGTAAAGACCTAT
TAGGAAGGCTAACATCATCCTCAG -> AGGAAGGCTAACATCATCCTCAGG
GGCTAACGCGTCTCGCTCAGTTTC -> GCTAACGCGTCTCGCTCAGTTTCC
TTTAACAGTGTACATTCTGTTCAT -> TTAACAGTGTACATTCTGTTCATA
TTACCGCGCATCTTGATGAGCCCC -> TACCGCGCATCTTGATGAGCCCCC
CAGTATATCAATTTCAATCAAAGA -> AGTATATCAATTTCAATCAAAGAG
TCACATGACTCACCGGTCCATTCA -> CACATGACTCACCGGTCCATTCAC
TGACTCACCGGTCCATTCACCTTG -> GACTCACCGGTCCATTCACCTTGT
CGCACAACTGCGATTTTGTCAGCA -> GCACAACTGCGATTTTGTCAGCAG
AGCCCTCATTAACGCGCGGCCTCG -> GCCCTCATTAACGCGCGGCCTCGG
TATGTATTTAGAGTTGAAACTCTT -> ATGTATTTAGAGTTGAAACTCTTA
TGTGCTTGCGACCCCTTACCAATC -> GTGCTTGCGACCCCTTACCAATCT
TCAGATTCGACCGGATTAGTAATT -> CAGATTCGACCGGATTAGTAATTG
ATGCCTGAATATGTACGACGGCCA -> TGCCTGAATATGTACGACGGCCAC
ATATCGAGGGAATTATGCAATTTG -> TATCGAGGGAATTATGCAATTTGA
GGTCCACGAGAACGGGCGCACCCC -> GTCCACGAGAACGGGCGCACCCCT
CAAAGTAGTTGGGAGTGGTTGGGT -> AAAGTAGTTGGGAGTGGTTGGGTA
GCAATTTGACTTATTCATCAGTAA -> CAATTTGACTTATTCATCAGTAAC
AACCCGCTACCAACAAATTAATAT -> ACCCGCTACCAACAAATTAATATT
GATGACCTATATGTAACTCTTTCT -> ATGACCTATATGTAACTCTTTCTG
CAATCCAGAAGCTGCCTCAAGTAG -> AATCCAGAAGCTGCCTCAAGTAGC
CTCGCTCAGTTTCCCACTTATTTA -> TCGCTCAGTTTCCCACTTATTTAA
TTGTCTAGCGAACCATCCTCATAG -> TGTCTAGCGAACCATCCTCATAGC
ACACGCATAAGAGGAAGGCACTAT -> CACGCATAAGAGGAAGGCACTATA
AATAAAACAGACATTATCCTTTCT -> ATAAAACAGACATTATCCTTTCTC
CCGTGCCTTGGCTAACGCGTCTCG -> CGTGCCTTGGCTAACGCGTCTCGC
GTAATAAAACAGACATTATCCTTT -> TAATAAAACAGACATTATCCTTTC
CCCTACGAAGGACACGACGAGCAC -> CCTACGAAGGACACGACGAGCACG
CGTAAATCCTAATCCTATTAGCCC -> GTAAATCCTAATCCTATTAGCCCA
AGTTGGACTTTTCCCCCCCTCAAG -> GTTGGACTTTTCCCCCCCTCAAGG
GACAGGCTCCCTCCTCCGGGGCTA -> ACAGGCTCCCTCCTCCGGGGCTAG
CAATGACAGAATTCTGGTCTTGGA -> AATGACAGAATTCTGGTCTTGGAG
ATACACGCAGTGGGTGAGACATCG -> TACACGCAGTGGGTGAGACATCGA
GACACATTAAAGTAGTGCATAGAG -> ACACATTAAAGTAGTGCATAGAGT
AACAGACATTATCCTTTCTCGTTG -> ACAGACATTATCCTTTCTCGTTGC
GAACCGCAGTACTAACAATTGAGT -> AACCGCAGTACTAACAATTGAGTT
TTCTCTAGCAAGAACTGAGGCGAG -> TCTCTAGCAAGAACTGAGGCGAGA
AATCGCTGTTATGAACCGCAGTAC -> ATCGCTGTTATGAACCGCAGTACT
AGGCTGTTGAGCAATAGATTGTGA -> GGCTGTTGAGCAATAGATTGTGAC
TGTATTTAGAGTTGAAACTCTTAG -> GTATTTAGAGTTGAAACTCTTAGA
CTTCGAACGGGAATCACTGCTAGT -> TTCGAACGGGAATCACTGCTAGTA
TATTACCGCGCATCTTGATGAGCC -> ATTACCGCGCATCTTGATGAGCCC
AGTTATACACGCAGTGGGTGAGAC -> GTTATACACGCAGTGGGTGAGACA
AGCGTATGGACATGAATGACCCTA -> GCGTATGGACATGAATGACCCTAA
AGCCTATTCAGAGGATGCGCTTGG -> GCCTATTCAGAGGATGCGCTTGGA
GTCTTGTGAATCGCTGTTATGAAC -> TCTTGTGAATCGCTGTTATGAACC
GAAAGAAGCTAAATTCAGATTCGA -> AAAGAAGCTAAATTCAGATTCGAC
ACTTATTTAAGACTACCGATTAAT -> CTTATTTAAGACTACCGATTAATA
TAAAGACCTATTTGTAATTTGGGG -> AAAGACCTATTTGTAATTTGGGGT
ACTAAGGTATTTATCCTCCCCTAC -> CTAAGGTATTTATCCTCCCCTACG
TACCGCGCATCTTGATGAGCCCCC -> ACCGCGCATCTTGATGAGCCCCCG
CCAGCGGACAAAGGGTCCACGAGA -> CAGCGGACAAAGGGTCCACGAGAA
TACCAATCTAGAAGTGATCAACCC -> ACCAATCTAGAAGTGATCAACCCG
GAAGGACACGACGAGCACGTCGGT -> AAGGACACGACGAGCACGTCGGTC
GCGGGGCATGTCGAGTATCATTCA -> CGGGGCATGTCGAGTATCATTCAA
CACGCATAAGAGGAAGGCACTATA -> ACGCATAAGAGGAAGGCACTATAG
CACGCAGTGGGTGAGACATCGAAA -> ACGCAGTGGGTGAGACATCGAAAG
GGAGACAGGCTCCCTCCTCCGGGG -> GAGACAGGCTCCCTCCTCCGGGGC
GGTTGGGTAAGTGTGGAGACAGGC -> GTTGGGTAAGTGTGGAGACAGGCT
GCTGTTGAGCAATAGATTGTGACG -> CTGTTGAGCAATAGATTGTGACGT
TAACTCCGGCCACCAAACCGGTGG -> AACTCCGGCCACCAAACCGGTGGA
GTCTAGCGAACCATCCTCATAGCA -> TCTAGCGAACCATCCTCATAGCAA
GGCTTCATTGGCGGAACAGTGGGG -> GCTTCATTGGCGGAACAGTGGGGT
GTAAAGACCTATTTGTAATTTGGG -> TAAAGACCTATTTGTAATTTGGGG
CAACTAAGGTATTTATCCTCCCCT -> AACTAAGGTATTTATCCTCCCCTA
AGGCGTGTTAGCCAAAGTAGTTGG -> GGCGTGTTAGCCAAAGTAGTTGGG
ACCGCCCACAGACACATTAAAGTA -> CCGCCCACAGACACATTAAAGTAG
TCGTGGGTAGCGTAACGGCCTTCA -> CGTGGGTAGCGTAACGGCCTTCAA
TCAGCCGAACGGCAACCACCTTTT -> CAGCCGAACGGCAACCACCTTTTT
ACGTCAAAGGCAAAGATAGATGGT -> CGTCAAAGGCAAAGATAGATGGTT
GATCGTAAATCCTAATCCTATTAG -> ATCGTAAATCCTAATCCTATTAGC
TTGGCTAACGCGTCTCGCTCAGTT -> TGGCTAACGCGTCTCGCTCAGTTT
ACGGGAATCACTGCTAGTAGTAAC -> CGGGAATCACTGCTAGTAGTAACA
TAGTAGGAAGGCTAACATCATCCT -> AGTAGGAAGGCTAACATCATCCTC
CGCCCACAGACACATTAAAGTAGT -> GCCCACAGACACATTAAAGTAGTG
CACATTAAAGTAGTGCATAGAGTA -> ACATTAAAGTAGTGCATAGAGTAA
AACATCATCCTCAGGTTGTGGGGT -> ACATCATCCTCAGGTTGTGGGGTC
AAAGATAGATGGTTGAGGGGCCCG -> AAGATAGATGGTTGAGGGGCCCGA
GTCAAAGGCAAAGATAGATGGTTG -> TCAAAGGCAAAGATAGATGGTTGA
CCCACTTATTTAAGACTACCGATT -> CCACTTATTTAAGACTACCGATTA
GCACGTCGGTCTTGTGAATCGCTG -> CACGTCGGTCTTGTGAATCGCTGT
GGACTAGATGCCGAGCGTACGTCA -> GACTAGATGCCGAGCGTACGTCAA
AAAGAGCCCTCATTAACGCGCGGC -> AAGAGCCCTCATTAACGCGCGGCC
GTGTGGAGACAGGCTCCCTCCTCC -> TGTGGAGACAGGCTCCCTCCTCCG
GAATTCTGGTCTTGGAGCGGCAAG -> AATTCTGGTCTTGGAGCGGCAAGA
TCTAGAAGTGATCAACCCGCTACC -> CTAGAAGTGATCAACCCGCTACCA
ACTCGTAACAGCGATAATGGCTCT -> CTCGTAACAGCGATAATGGCTCTG
CTCATAGCAAGGATATAACCCCAG -> TCATAGCAAGGATATAACCCCAGC
GTTGAGGGGCCCGACTCATAAAGG -> TTGAGGGGCCCGACTCATAAAGGC
ACGACGAGCACGTCGGTCTTGTGA -> CGACGAGCACGTCGGTCTTGTGAA
CTTGTCACATGACTCACCGGTCCA -> TTGTCACATGACTCACCGGTCCAT
CAAAGAGCCCTCATTAACGCGCGG -> AAAGAGCCCTCATTAACGCGCGGC
GTTACAGTAGAGGGGCTATTCTCT -> TTACAGTAGAGGGGCTATTCTCTA
TACACGCAGTGGGTGAGACATCGA -> ACACGCAGTGGGTGAGACATCGAA
AGCACGTCGGTCTTGTGAATCGCT -> GCACGTCGGTCTTGTGAATCGCTG
GGGATTGGTTGCGGGGCATGTCGA -> GGATTGGTTGCGGGGCATGTCGAG
TCTTTTCTATGCGGTGCAGTAACT -> CTTTTCTATGCGGTGCAGTAACTC
TTGCGGGGCATGTCGAGTATCATT -> TGCGGGGCATGTCGAGTATCATTC
ACAAGTACGACTGGGCGGCTCGGT -> CAAGTACGACTGGGCGGCTCGGTG
CTGAGGCGAGACTGCATGACATCA -> TGAGGCGAGACTGCATGACATCAT
GCGTATGGACATGAATGACCCTAA -> CGTATGGACATGAATGACCCTAAC
GGTGCAATTCGTTTATGTCGTGGG -> GTGCAATTCGTTTATGTCGTGGGT
CACTTATTTAAGACTACCGATTAA -> ACTTATTTAAGACTACCGATTAAT
GGCATCCTTGCCCGGAATGCCTGA -> GCATCCTTGCCCGGAATGCCTGAA
GACAAGGTGTTGGTCTTTTCTATG -> ACAAGGTGTTGGTCTTTTCTATGC
TACTAACAATTGAGTTATACACGC -> ACTAACAATTGAGTTATACACGCA
TATTTTATTAGTTGACAAGGTGTT -> ATTTTATTAGTTGACAAGGTGTTG
GTCTTGGAGCGGCAAGATCAATAT -> TCTTGGAGCGGCAAGATCAATATG
CAGGCCTTTAACTCGTAACAGCGA -> AGGCCTTTAACTCGTAACAGCGAT
TAATATTGGACGCGCAGGGATTGG -> AATATTGGACGCGCAGGGATTGGT
CTATTCAGAGGATGCGCTTGGAAA -> TATTCAGAGGATGCGCTTGGAAAA
CGAGGGAATTATGCAATTTGACTT -> GAGGGAATTATGCAATTTGACTTA
TCATTATAGTTGGAACCAGTATAT -> CATTATAGTTGGAACCAGTATATC
CTCGGCATTCTCAATCCAGAAGCT -> TCGGCATTCTCAATCCAGAAGCTG
AATTATGCAATTTGACTTATTCAT -> ATTATGCAATTTGACTTATTCATC
AATTTCAATCAAAGAGCCCTCATT -> ATTTCAATCAAAGAGCCCTCATTA
AGTACGACTGGGCGGCTCGGTGCA -> GTACGACTGGGCGGCTCGGTGCAA
AACATTACAATGACAGAATTCTGG -> ACATTACAATGACAGAATTCTGGT
TGGGGTCACCTTTAACAGTGTACA -> GGGGTCACCTTTAACAGTGTACAT
AAGCTAAATTCAGATTCGACCGGA -> AGCTAAATTCAGATTCGACCGGAT
CAATCAAAGAGCCCTCATTAACGC -> AATCAAAGAGCCCTCATTAACGCG
GTTGGTCTTTTCTATGCGGTGCAG -> TTGGTCTTTTCTATGCGGTGCAGT
TGTTAGCCAAAGTAGTTGGGAGTG -> GTTAGCCAAAGTAGTTGGGAGTGG
CGTGTTAGCCAAAGTAGTTGGGAG -> GTGTTAGCCAAAGTAGTTGGGAGT
TAGCGTAACGGCCTTCAATGTCGT -> AGCGTAACGGCCTTCAATGTCGTG
GCAAGATCAATATGCAATGCAGGG -> CAAGATCAATATGCAATGCAGGGC
GCAGAACGGCATTCGCAATTGATA -> CAGAACGGCATTCGCAATTGATAT
ATTAGCCCAGCGGACAAAGGGTCC -> TTAGCCCAGCGGACAAAGGGTCCA
CGAAAGTCAGCCGAACGGCAACCA -> GAAAGTCAGCCGAACGGCAACCAC
TTGATATTTTATTAGTTGACAAGG -> TGATATTTTATTAGTTGACAAGGT
CATTCAAAAGTTGTCAACGTATTC -> ATTCAAAAGTTGTCAACGTATTCC
CGGGGCATGTCGAGTATCATTCAA -> GGGGCATGTCGAGTATCATTCAAA
CGGCTCGGTGCAATTCGTTTATGT -> GGCTCGGTGCAATTCGTTTATGTC
GACAGCGTTATGCTGGATCGTAAA -> ACAGCGTTATGCTGGATCGTAAAT
GACTAGATGCCGAGCGTACGTCAA -> ACTAGATGCCGAGCGTACGTCAAA
ATCATTCAAAAGTTGTCAACGTAT -> TCATTCAAAAGTTGTCAACGTATT
GGCTAACATCATCCTCAGGTTGTG -> GCTAACATCATCCTCAGGTTGTGG
AATTGATATTTTATTAGTTGACAA -> ATTGATATTTTATTAGTTGACAAG
CCGGAATGCCTGAATATGTACGAC -> CGGAATGCCTGAATATGTACGACG
TCAATGTCGTGGGGACTAGGACGG -> CAATGTCGTGGGGACTAGGACGGA
TGTGAATCGCTGTTATGAACCGCA -> GTGAATCGCTGTTATGAACCGCAG
GCCCCCGATCACCTAACGCTATGA -> CCCCCGATCACCTAACGCTATGAC
TGCCCGGAATGCCTGAATATGTAC -> GCCCGGAATGCCTGAATATGTACG
TCCTTGCCCGGAATGCCTGAATAT -> CCTTGCCCGGAATGCCTGAATATG
CCTCATAGCAAGGATATAACCCCA -> CTCATAGCAAGGATATAACCCCAG
CAGAACGGCATTCGCAATTGATAT -> AGAACGGCATTCGCAATTGATATT
TTGAGCAATAGATTGTGACGTTAT -> TGAGCAATAGATTGTGACGTTATT
TCCTCAGGTTGTGGGGTCACCTTT -> CCTCAGGTTGTGGGGTCACCTTTA
CCGAGCGTACGTCAAAGGCAAAGA -> CGAGCGTACGTCAAAGGCAAAGAT
GGACGCGCAGGGATTGGTTGCGGG -> GACGCGCAGGGATTGGTTGCGGGG
ACAGACACATTAAAGTAGTGCATA -> CAGACACATTAAAGTAGTGCATAG
GAACGGGAATCACTGCTAGTAGTA -> AACGGGAATCACTGCTAGTAGTAA
ATCTTGATGAGCCCCCGATCACCT -> TCTTGATGAGCCCCCGATCACCTA
AAATCTTGTTTTGTCAGTATATCA -> AATCTTGTTTTGTCAGTATATCAA
ACATTACAATGACAGAATTCTGGT -> CATTACAATGACAGAATTCTGGTC
CCTAACGCTATGACTGGCTTCATT -> CTAACGCTATGACTGGCTTCATTG
AATATTGGACGCGCAGGGATTGGT -> ATATTGGACGCGCAGGGATTGGTT
GACCTATATGTAACTCTTTCTGCG -> ACCTATATGTAACTCTTTCTGCGT
GCGTCTCGCTCAGTTTCCCACTTA -> CGTCTCGCTCAGTTTCCCACTTAT
CCTTTTTCGGAGTTGGACTTTTCC -> CTTTTTCGGAGTTGGACTTTTCCC
TAGTTGGGAGTGGTTGGGTAAGTG -> AGTTGGGAGTGGTTGGGTAAGTGT
GGGTCACCTTTAACAGTGTACATT -> GGTCACCTTTAACAGTGTACATTC
CATGTCGAGTATCATTCAAAAGTT -> ATGTCGAGTATCATTCAAAAGTTG
GGCCACCAAACCGGTGGAACACGC -> GCCACCAAACCGGTGGAACACGCA
ATTGATATTTTATTAGTTGACAAG -> TTGATATTTTATTAGTTGACAAGG
ACAAGGTGTTGGTCTTTTCTATGC -> CAAGGTGTTGGTCTTTTCTATGCG
AGTAGTAACAAGTACGACTGGGCG -> GTAGTAACAAGTACGACTGGGCGG
GCGTTCGTCCTTGTCACATGACTC -> CGTTCGTCCTTGTCACATGACTCA
CAGACACATTAAAGTAGTGCATAG -> AGACACATTAAAGTAGTGCATAGA
CATGAATGACCCTAACTACAGCTC -> ATGAATGACCCTAACTACAGCTCC
GGGGCATGTCGAGTATCATTCAAA -> GGGCATGTCGAGTATCATTCAAAA
AAGTCAGCCGAACGGCAACCACCT -> AGTCAGCCGAACGGCAACCACCTT
CAGTACTAACAATTGAGTTATACA -> AGTACTAACAATTGAGTTATACAC
AGATCAATATGCAATGCAGGGCCT -> GATCAATATGCAATGCAGGGCCTT
TTCTCAATCCAGAAGCTGCCTCAA -> TCTCAATCCAGAAGCTGCCTCAAG
AGCAGCACAACTAAGGTATTTATC -> GCAGCACAACTAAGGTATTTATCC
TCTCGCTCAGTTTCCCACTTATTT -> CTCGCTCAGTTTCCCACTTATTTA
TCCCCCCCTCAAGGCCTGTAGTAG -> CCCCCCCTCAAGGCCTGTAGTAGG
CTGGTCTTGGAGCGGCAAGATCAA -> TGGTCTTGGAGCGGCAAGATCAAT
CGCTACCAACAAATTAATATTGGA -> GCTACCAACAAATTAATATTGGAC
TAATGGCTCTGATCTGACTTTAGC -> AATGGCTCTGATCTGACTTTAGCC
ATATTTTATTAGTTGACAAGGTGT -> TATTTTATTAGTTGACAAGGTGTT
TACGACGGCCACATTCGAAAGAAG -> ACGACGGCCACATTCGAAAGAAGC
ACATGCTTAGTCGCACAACTGCGA -> CATGCTTAGTCGCACAACTGCGAT
CTATGCGGTGCAGTAACTCGCGTT -> TATGCGGTGCAGTAACTCGCGTTC
CATCGAAAGTCAGCCGAACGGCAA -> ATCGAAAGTCAGCCGAACGGCAAC
CACGTCGGTCTTGTGAATCGCTGT -> ACGTCGGTCTTGTGAATCGCTGTT
GCAATAGATTGTGACGTTATTAGT -> CAATAGATTGTGACGTTATTAGTC
CCTTGGCTAACGCGTCTCGCTCAG -> CTTGGCTAACGCGTCTCGCTCAGT
GTTGGAACCAGTATATCGAGGGAA -> TTGGAACCAGTATATCGAGGGAAT
TATTGGACGCGCAGGGATTGGTTG -> ATTGGACGCGCAGGGATTGGTTGC
ACAGCGATAATGGCTCTGATCTGA -> CAGCGATAATGGCTCTGATCTGAC
ACGAGAGGCGTGCCGTGCCTTGGC -> CGAGAGGCGTGCCGTGCCTTGGCT
ACAGCGTTATGCTGGATCGTAAAT -> CAGCGTTATGCTGGATCGTAAATC
GCTAGTAGTAACAAGTACGACTGG -> CTAGTAGTAACAAGTACGACTGGG
ACGCATAAGAGGAAGGCACTATAG -> CGCATAAGAGGAAGGCACTATAGC
AAACAGACATTATCCTTTCTCGTT -> AACAGACATTATCCTTTCTCGTTG
GGGGTTACAGTAGAGGGGCTATTC -> GGGTTACAGTAGAGGGGCTATTCT
ATTCTGTTCATAAAAAACGCTAAA -> TTCTGTTCATAAAAAACGCTAAAC
CGACCCCTTACCAATCTAGAAGTG -> GACCCCTTACCAATCTAGAAGTGA
GAATGACCCTAACTACAGCTCCCG -> AATGACCCTAACTACAGCTCCCGC
GAAGCTAAATTCAGATTCGACCGG -> AAGCTAAATTCAGATTCGACCGGA
AGCCGTGGTCCACTTCTTTAGTAA -> GCCGTGGTCCACTTCTTTAGTAAA
GAATCGCTGTTATGAACCGCAGTA -> AATCGCTGTTATGAACCGCAGTAC
CACGAGAACGGGCGCACCCCTATA -> ACGAGAACGGGCGCACCCCTATAC
ATCCTATTAGCCCAGCGGACAAAG -> TCCTATTAGCCCAGCGGACAAAGG
ACAGGGGTTACAGTAGAGGGGCTA -> CAGGGGTTACAGTAGAGGGGCTAT
ATCGAAAGTCAGCCGAACGGCAAC -> TCGAAAGTCAGCCGAACGGCAACC
TATTTAGAGTTGAAACTCTTAGAT -> ATTTAGAGTTGAAACTCTTAGATT
CACATTCGAAAGAAGCTAAATTCA -> ACATTCGAAAGAAGCTAAATTCAG
ATAAAAAACGCTAAACTGTGGGGC -> TAAAAAACGCTAAACTGTGGGGCC
AGGCGTGCCGTGCCTTGGCTAACG -> GGCGTGCCGTGCCTTGGCTAACGC
GAGCCTATTCAGAGGATGCGCTTG -> AGCCTATTCAGAGGATGCGCTTGG
TGTTGAGCAATAGATTGTGACGTT -> GTTGAGCAATAGATTGTGACGTTA
TCTATGCGGTGCAGTAACTCGCGT -> CTATGCGGTGCAGTAACTCGCGTT
AACGCGCGGCCTCGGCATTCTCAA -> ACGCGCGGCCTCGGCATTCTCAAT
CTTATTTAAGACTACCGATTAATA -> TTATTTAAGACTACCGATTAATAA
CAATGTCGTGGGGACTAGGACGGA -> AATGTCGTGGGGACTAGGACGGAA
ATCGTAAATCCTAATCCTATTAGC -> TCGTAAATCCTAATCCTATTAGCC
TGCAATTCGTTTATGTCGTGGGTA -> GCAATTCGTTTATGTCGTGGGTAG
ACGACGGCCACATTCGAAAGAAGC -> CGACGGCCACATTCGAAAGAAGCT
TTATTAGTTGACAAGGTGTTGGTC -> TATTAGTTGACAAGGTGTTGGTCT
CCGGCCACCAAACCGGTGGAACAC -> CGGCCACCAAACCGGTGGAACACG
ACTGCGATTTTGTCAGCAGCACAA -> CTGCGATTTTGTCAGCAGCACAAC
AGGAAGGCACTATAGCTTCGAACG -> GGAAGGCACTATAGCTTCGAACGG
AATCCTATTAGCCCAGCGGACAAA -> ATCCTATTAGCCCAGCGGACAAAG
GCCATGGAGCGTATGGACATGAAT -> CCATGGAGCGTATGGACATGAATG
GCAGGGATTGGTTGCGGGGCATGT -> CAGGGATTGGTTGCGGGGCATGTC
GAGAACGGGCGCACCCCTATACTC -> AGAACGGGCGCACCCCTATACTCA
TCGAGGGAATTATGCAATTTGACT -> CGAGGGAATTATGCAATTTGACTT
TCGCACAACTGCGATTTTGTCAGC -> CGCACAACTGCGATTTTGTCAGCA
TGAGCCTATTCAGAGGATGCGCTT -> GAGCCTATTCAGAGGATGCGCTTG
GGTGGAACACGCATAAGAGGAAGG -> GTGGAACACGCATAAGAGGAAGGC
ACGCGTCTCGCTCAGTTTCCCACT -> CGCGTCTCGCTCAGTTTCCCACTT
AAATTAATATTGGACGCGCAGGGA -> AATTAATATTGGACGCGCAGGGAT
GGTAAGTGTGGAGACAGGCTCCCT -> GTAAGTGTGGAGACAGGCTCCCTC
GACCGCCCACAGACACATTAAAGT -> ACCGCCCACAGACACATTAAAGTA
AATTTGGGGTGGCACATGCTTAGT -> ATTTGGGGTGGCACATGCTTAGTC
TCCCGCAGGCCTTTAACTCGTAAC -> CCCGCAGGCCTTTAACTCGTAACA
TTCTAAAGCTGAGCCTATTCAGAG -> TCTAAAGCTGAGCCTATTCAGAGG
TACAATGACAGAATTCTGGTCTTG -> ACAATGACAGAATTCTGGTCTTGG
ATCAACCCGCTACCAACAAATTAA -> TCAACCCGCTACCAACAAATTAAT
GCATGTCGAGTATCATTCAAAAGT -> CATGTCGAGTATCATTCAAAAGTT
GAGCCCCCGATCACCTAACGCTAT -> AGCCCCCGATCACCTAACGCTATG
GACGCGCAGGGATTGGTTGCGGGG -> ACGCGCAGGGATTGGTTGCGGGGC
TCCCTCCTCCGGGGCTAGGCATCC -> CCCTCCTCCGGGGCTAGGCATCCT
AGGTGTACTAAGGCGTGTTAGCCA -> GGTGTACTAAGGCGTGTTAGCCAA
GCGCTTGGAAAATCTTGTTTTGTC -> CGCTTGGAAAATCTTGTTTTGTCA
TGCTCTCTATAGCGCCCCCTAAAT -> GCTCTCTATAGCGCCCCCTAAATG
CACCTAACGCTATGACTGGCTTCA -> ACCTAACGCTATGACTGGCTTCAT
GCGGAACAGTGGGGTGCAGAACGG -> CGGAACAGTGGGGTGCAGAACGGC
GGAGTGGTTGGGTAAGTGTGGAGA -> GAGTGGTTGGGTAAGTGTGGAGAC
CTGATCTGACTTTAGCCGTGGTCC -> TGATCTGACTTTAGCCGTGGTCCA
GAAGGCACTATAGCTTCGAACGGG -> AAGGCACTATAGCTTCGAACGGGA
TCAACATTACAATGACAGAATTCT -> CAACATTACAATGACAGAATTCTG
ACTGGGCGGCTCGGTGCAATTCGT -> CTGGGCGGCTCGGTGCAATTCGTT
CTGGCTTCATTGGCGGAACAGTGG -> TGGCTTCATTGGCGGAACAGTGGG
CATGCTTAGTCGCACAACTGCGAT -> ATGCTTAGTCGCACAACTGCGATT
CGAAAGAAGCTAAATTCAGATTCG -> GAAAGAAGCTAAATTCAGATTCGA
AATATGTACGACGGCCACATTCGA -> ATATGTACGACGGCCACATTCGAA
GGGCCTCTGGTTTTCCAGCTCGGG -> GGCCTCTGGTTTTCCAGCTCGGGT
CCAGCGCGTTCGTAAAACAATCGC -> CAGCGCGTTCGTAAAACAATCGCT
TTATTTAAGACTACCGATTAATAA -> TATTTAAGACTACCGATTAATAAC
TAGTAATTGTCTAGCGAACCATCC -> AGTAATTGTCTAGCGAACCATCCT
GTTACTGGGAGGTAATAAAACAGA -> TTACTGGGAGGTAATAAAACAGAC
AAGTGTGGAGACAGGCTCCCTCCT -> AGTGTGGAGACAGGCTCCCTCCTC
CCGATTAATAACAGGGGTTACAGT -> CGATTAATAACAGGGGTTACAGTA
AGCACAACTAAGGTATTTATCCTC -> GCACAACTAAGGTATTTATCCTCC
GATGGTTGAGGGGCCCGACTCATA -> ATGGTTGAGGGGCCCGACTCATAA
ATTTGTAATTTGGGGTGGCACATG -> TTTGTAATTTGGGGTGGCACATGC
AAGGTATTTATCCTCCCCTACGAA -> AGGTATTTATCCTCCCCTACGAAG
CTAGATGCCGAGCGTACGTCAAAG -> TAGATGCCGAGCGTACGTCAAAGG
CCATCCTCATAGCAAGGATATAAC -> CATCCTCATAGCAAGGATATAACC
CTATTACCGCGCATCTTGATGAGC -> TATTACCGCGCATCTTGATGAGCC
CTGGGCGGCTCGGTGCAATTCGTT -> TGGGCGGCTCGGTGCAATTCGTTT
TATGACTGGCTTCATTGGCGGAAC -> ATGACTGGCTTCATTGGCGGAACA
AAGACCTATTTGTAATTTGGGGTG -> AGACCTATTTGTAATTTGGGGTGG
ACGTATTCCTTCTAAAGCTGAGCC -> CGTATTCCTTCTAAAGCTGAGCCT
ACTTTTCCCCCCCTCAAGGCCTGT -> CTTTTCCCCCCCTCAAGGCCTGTA
CATTCTCAATCCAGAAGCTGCCTC -> ATTCTCAATCCAGAAGCTGCCTCA
ACTCACCGGTCCATTCACCTTGTC -> CTCACCGGTCCATTCACCTTGTCG
GGCTCTGATCTGACTTTAGCCGTG -> GCTCTGATCTGACTTTAGCCGTGG
ATGAACCGCAGTACTAACAATTGA -> TGAACCGCAGTACTAACAATTGAG
TGATGACCTATATGTAACTCTTTC -> GATGACCTATATGTAACTCTTTCT
CAGCTCCCGCAGGCCTTTAACTCG -> AGCTCCCGCAGGCCTTTAACTCGT
ATCTAGAAGTGATCAACCCGCTAC -> TCTAGAAGTGATCAACCCGCTACC
TTTTCCAGCTCGGGTTGATTGATT -> TTTCCAGCTCGGGTTGATTGATTG
AAAATCTTGTTTTGTCAGTATATC -> AAATCTTGTTTTGTCAGTATATCA
AGGACGGAATCGACGACGAGAGGC -> GGACGGAATCGACGACGAGAGGCG
GATTAGTAATTGTCTAGCGAACCA -> ATTAGTAATTGTCTAGCGAACCAT
CCTTACCAATCTAGAAGTGATCAA -> CTTACCAATCTAGAAGTGATCAAC
GGCTCCCTCCTCCGGGGCTAGGCA -> GCTCCCTCCTCCGGGGCTAGGCAT
GACTTTTCCCCCCCTCAAGGCCTG -> ACTTTTCCCCCCCTCAAGGCCTGT
ATGACAGAATTCTGGTCTTGGAGC -> TGACAGAATTCTGGTCTTGGAGCG
TGTCAGCAGCACAACTAAGGTATT -> GTCAGCAGCACAACTAAGGTATTT
ATTCCTTCTAAAGCTGAGCCTATT -> TTCCTTCTAAAGCTGAGCCTATTC
TAACTACAGCTCCCGCAGGCCTTT -> AACTACAGCTCCCGCAGGCCTTTA
CCTATTCAGAGGATGCGCTTGGAA -> CTATTCAGAGGATGCGCTTGGAAA
TTAATAACAGGGGTTACAGTAGAG -> TAATAACAGGGGTTACAGTAGAGG
CTTAGTCGCACAACTGCGATTTTG -> TTAGTCGCACAACTGCGATTTTGT
AACTCTTAGATTTCGATTGGAGTT -> ACTCTTAGATTTCGATTGGAGTTG
CAACCCGCTACCAACAAATTAATA -> AACCCGCTACCAACAAATTAATAT
CTGCCTCAAGTAGCAGGCTGTTGA -> TGCCTCAAGTAGCAGGCTGTTGAG
CTCGGGTTGATTGATTGCATACTA -> TCGGGTTGATTGATTGCATACTAG
GACGAGCACGTCGGTCTTGTGAAT -> ACGAGCACGTCGGTCTTGTGAATC
CGGTCTTGTGAATCGCTGTTATGA -> GGTCTTGTGAATCGCTGTTATGAA
TTCATCAGTAACTTTGTGCTTGCG -> TCATCAGTAACTTTGTGCTTGCGA
ATGACTCACCGGTCCATTCACCTT -> TGACTCACCGGTCCATTCACCTTG
TGGGGCCTCTGGTTTTCCAGCTCG -> GGGGCCTCTGGTTTTCCAGCTCGG
TGGTCTTTTCTATGCGGTGCAGTA -> GGTCTTTTCTATGCGGTGCAGTAA
GAGGAAGGCACTATAGCTTCGAAC -> AGGAAGGCACTATAGCTTCGAACG
CCGGTCCATTCACCTTGTCGCGCT -> CGGTCCATTCACCTTGTCGCGCTT
GCTGCCATGGAGCGTATGGACATG -> CTGCCATGGAGCGTATGGACATGA
CGACTGGGCGGCTCGGTGCAATTC -> GACTGGGCGGCTCGGTGCAATTCG
TTGTTTTGTCAGTATATCAATTTC -> TGTTTTGTCAGTATATCAATTTCA
GTGGGGTGCAGAACGGCATTCGCA -> TGGGGTGCAGAACGGCATTCGCAA
TCTCTATAGCGCCCCCTAAATGAT -> CTCTATAGCGCCCCCTAAATGATG
TGGGGACTAGGACGGAATCGACGA -> GGGGACTAGGACGGAATCGACGAC
AGACCTATTTGTAATTTGGGGTGG -> GACCTATTTGTAATTTGGGGTGGC
TCACCTTTAACAGTGTACATTCTG -> CACCTTTAACAGTGTACATTCTGT
AACTGAGGCGAGACTGCATGACAT -> ACTGAGGCGAGACTGCATGACATC
TGCAGGGCCTTGGCTAGGCACTAT -> GCAGGGCCTTGGCTAGGCACTATT
CGGACAAAGGGTCCACGAGAACGG -> GGACAAAGGGTCCACGAGAACGGG
AGGCACTATAGCTTCGAACGGGAA -> GGCACTATAGCTTCGAACGGGAAT
GCCCCCTAAATGATGACCTATATG -> CCCCCTAAATGATGACCTATATGT
CTCCGGGGCTAGGCATCCTTGCCC -> TCCGGGGCTAGGCATCCTTGCCCG
GAGCAATAGATTGTGACGTTATTA -> AGCAATAGATTGTGACGTTATTAG
GGGGCCTCTGGTTTTCCAGCTCGG -> GGGCCTCTGGTTTTCCAGCTCGGG
GAACGGCAACCACCTTTTTCGGAG -> AACGGCAACCACCTTTTTCGGAGT
AACGGCAACCACCTTTTTCGGAGT -> ACGGCAACCACCTTTTTCGGAGTT
AATTTGACTTATTCATCAGTAACT -> ATTTGACTTATTCATCAGTAACTT
TTTTCGGAGTTGGACTTTTCCCCC -> TTTCGGAGTTGGACTTTTCCCCCC
CTAAATTCAGATTCGACCGGATTA -> TAAATTCAGATTCGACCGGATTAG
TGAAACTCTTAGATTTCGATTGGA -> GAAACTCTTAGATTTCGATTGGAG
TATTTAAGACTACCGATTAATAAC -> ATTTAAGACTACCGATTAATAACA
CATAAGAGGAAGGCACTATAGCTT -> ATAAGAGGAAGGCACTATAGCTTC
TGTGGAGACAGGCTCCCTCCTCCG -> GTGGAGACAGGCTCCCTCCTCCGG
CACTTCTTTAGTAAAGACCTATTT -> ACTTCTTTAGTAAAGACCTATTTG
CTTAGATTTCGATTGGAGTTGGGA -> TTAGATTTCGATTGGAGTTGGGAC
ATTATCCTTTCTCGTTGCTGCCAT -> TTATCCTTTCTCGTTGCTGCCATG
GAATGCCTGAATATGTACGACGGC -> AATGCCTGAATATGTACGACGGCC
GTGCAATTCGTTTATGTCGTGGGT -> TGCAATTCGTTTATGTCGTGGGTA
CCTATATGTAACTCTTTCTGCGTT -> CTATATGTAACTCTTTCTGCGTTA
GCGGTGCAGTAACTCGCGTTCGTC -> CGGTGCAGTAACTCGCGTTCGTCC
AGGGTCCACGAGAACGGGCGCACC -> GGGTCCACGAGAACGGGCGCACCC
TTTCCAGCTCGGGTTGATTGATTG -> TTCCAGCTCGGGTTGATTGATTGC
ACAGACATTATCCTTTCTCGTTGC -> CAGACATTATCCTTTCTCGTTGCT
GTCACATGACTCACCGGTCCATTC -> TCACATGACTCACCGGTCCATTCA
CACATGCTTAGTCGCACAACTGCG -> ACATGCTTAGTCGCACAACTGCGA
TTCTGCGTTAGACAGCGTTATGCT -> TCTGCGTTAGACAGCGTTATGCTG
GGCGTGCCGTGCCTTGGCTAACGC -> GCGTGCCGTGCCTTGGCTAACGCG
AGAGGAAGGCACTATAGCTTCGAA -> GAGGAAGGCACTATAGCTTCGAAC
ACCAGTATATCGAGGGAATTATGC -> CCAGTATATCGAGGGAATTATGCA
TTTTGTCAGTATATCAATTTCAAT -> TTTGTCAGTATATCAATTTCAATC
GGGCCCGACTCATAAAGGCAGGTG -> GGCCCGACTCATAAAGGCAGGTGT
GCATAGAGTAACTCCGGCCACCAA -> CATAGAGTAACTCCGGCCACCAAA
CTGGGAGGTAATAAAACAGACATT -> TGGGAGGTAATAAAACAGACATTA
GGCCTCGGCATTCTCAATCCAGAA -> GCCTCGGCATTCTCAATCCAGAAG
AACAAGTACGACTGGGCGGCTCGG -> ACAAGTACGACTGGGCGGCTCGGT
CAAGGATATAACCCCAGCGCGTTC -> AAGGATATAACCCCAGCGCGTTCG
CGTAAAACAATCGCTCAACATTAC -> GTAAAACAATCGCTCAACATTACA
ACGGCCACATTCGAAAGAAGCTAA -> CGGCCACATTCGAAAGAAGCTAAA
ACAGCTCCCGCAGGCCTTTAACTC -> CAGCTCCCGCAGGCCTTTAACTCG
GAGCGTATGGACATGAATGACCCT -> AGCGTATGGACATGAATGACCCTA
GGAAGGCTAACATCATCCTCAGGT -> GAAGGCTAACATCATCCTCAGGTT
ACAGGCTCCCTCCTCCGGGGCTAG -> CAGGCTCCCTCCTCCGGGGCTAGG
ATGAGCCCCCGATCACCTAACGCT -> TGAGCCCCCGATCACCTAACGCTA
ACATGAATGACCCTAACTACAGCT -> CATGAATGACCCTAACTACAGCTC
TAGGCATCCTTGCCCGGAATGCCT -> AGGCATCCTTGCCCGGAATGCCTG
CTATAGCTTCGAACGGGAATCACT -> TATAGCTTCGAACGGGAATCACTG
GAGACATCGAAAGTCAGCCGAACG -> AGACATCGAAAGTCAGCCGAACGG
TTAAAGTAGTGCATAGAGTAACTC -> TAAAGTAGTGCATAGAGTAACTCC
CCCTAACTACAGCTCCCGCAGGCC -> CCTAACTACAGCTCCCGCAGGCCT
AATCGACGACGAGAGGCGTGCCGT -> ATCGACGACGAGAGGCGTGCCGTG
GGACTAGGACGGAATCGACGACGA -> GACTAGGACGGAATCGACGACGAG
TCACTGCTAGTAGTAACAAGTACG -> CACTGCTAGTAGTAACAAGTACGA
GGTTGTGTTACTGGGAGGTAATAA -> GTTGTGTTACTGGGAGGTAATAAA
TTGCCCGGAATGCCTGAATATGTA -> TGCCCGGAATGCCTGAATATGTAC
CGAGTATCATTCAAAAGTTGTCAA -> GAGTATCATTCAAAAGTTGTCAAC
TGGGTAGCGTAACGGCCTTCAATG -> GGGTAGCGTAACGGCCTTCAATGT
TTTTCCCCCCCTCAAGGCCTGTAG -> TTTCCCCCCCTCAAGGCCTGTAGT
CTTGATGAGCCCCCGATCACCTAA -> TTGATGAGCCCCCGATCACCTAAC
TATGAACCGCAGTACTAACAATTG -> ATGAACCGCAGTACTAACAATTGA
ATGGCTCTGATCTGACTTTAGCCG -> TGGCTCTGATCTGACTTTAGCCGT
ATCCTTGCCCGGAATGCCTGAATA -> TCCTTGCCCGGAATGCCTGAATAT
GCAGTGGGTGAGACATCGAAAGTC -> CAGTGGGTGAGACATCGAAAGTCA
TAACTCGCGTTCGTCCTTGTCACA -> AACTCGCGTTCGTCCTTGTCACAT
AACTCGCGTTCGTCCTTGTCACAT -> ACTCGCGTTCGTCCTTGTCACATG
CCCGGAATGCCTGAATATGTACGA -> CCGGAATGCCTGAATATGTACGAC
CCAAAGTAGTTGGGAGTGGTTGGG -> CAAAGTAGTTGGGAGTGGTTGGGT
CACATGACTCACCGGTCCATTCAC -> ACATGACTCACCGGTCCATTCACC
CTTGGAAAATCTTGTTTTGTCAGT -> TTGGAAAATCTTGTTTTGTCAGTA
AGGGGGATTCCTCATTATAGTTGG -> GGGGGATTCCTCATTATAGTTGGA
GACTCATAAAGGCAGGTGTACTAA -> ACTCATAAAGGCAGGTGTACTAAG
AGATTTCGATTGGAGTTGGGACCG -> GATTTCGATTGGAGTTGGGACCGC
TCCTTGTCACATGACTCACCGGTC -> CCTTGTCACATGACTCACCGGTCC
ATAGCAAGGATATAACCCCAGCGC -> TAGCAAGGATATAACCCCAGCGCG
TGACAAGGTGTTGGTCTTTTCTAT -> GACAAGGTGTTGGTCTTTTCTATG
CCCCGATCACCTAACGCTATGACT -> CCCGATCACCTAACGCTATGACTG
GTGTTGGTCTTTTCTATGCGGTGC -> TGTTGGTCTTTTCTATGCGGTGCA
ATAAAACAGACATTATCCTTTCTC -> TAAAACAGACATTATCCTTTCTCG
CCGAGGACTAGATGCCGAGCGTAC -> CGAGGACTAGATGCCGAGCGTACG
GGGGATTCCTCATTATAGTTGGAA -> GGGATTCCTCATTATAGTTGGAAC
CTCACAACATTAAGACTATGTATT -> TCACAACATTAAGACTATGTATTT
GGCCTTCAATGTCGTGGGGACTAG -> GCCTTCAATGTCGTGGGGACTAGG
TGGACGCGCAGGGATTGGTTGCGG -> GGACGCGCAGGGATTGGTTGCGGG
CGGTGCAGTAACTCGCGTTCGTCC -> GGTGCAGTAACTCGCGTTCGTCCT
CATTACAATGACAGAATTCTGGTC -> ATTACAATGACAGAATTCTGGTCT
GTTGGGTAAGTGTGGAGACAGGCT -> TTGGGTAAGTGTGGAGACAGGCTC
TATTAGTTGACAAGGTGTTGGTCT -> ATTAGTTGACAAGGTGTTGGTCTT
GACTGGGCGGCTCGGTGCAATTCG -> ACTGGGCGGCTCGGTGCAATTCGT
GCTTGCGACCCCTTACCAATCTAG -> CTTGCGACCCCTTACCAATCTAGA
TTTATCCTCCCCTACGAAGGACAC -> TTATCCTCCCCTACGAAGGACACG
ATACTCACAACATTAAGACTATGT -> TACTCACAACATTAAGACTATGTA
GGAAAATCTTGTTTTGTCAGTATA -> GAAAATCTTGTTTTGTCAGTATAT
GCCACATTCGAAAGAAGCTAAATT -> CCACATTCGAAAGAAGCTAAATTC
GCCCACAGACACATTAAAGTAGTG -> CCCACAGACACATTAAAGTAGTGC
TTTTGTCAGCAGCACAACTAAGGT -> TTTGTCAGCAGCACAACTAAGGTA
CCTCAAGTAGCAGGCTGTTGAGCA -> CTCAAGTAGCAGGCTGTTGAGCAA
ACAAAGGGTCCACGAGAACGGGCG -> CAAAGGGTCCACGAGAACGGGCGC
TTTATGTCGTGGGTAGCGTAACGG -> TTATGTCGTGGGTAGCGTAACGGC
AGGATATAACCCCAGCGCGTTCGT -> GGATATAACCCCAGCGCGTTCGTA
GTGAATCGCTGTTATGAACCGCAG -> TGAATCGCTGTTATGAACCGCAGT
TAGCGAACCATCCTCATAGCAAGG -> AGCGAACCATCCTCATAGCAAGGA
TAACAATTGAGTTATACACGCAGT -> AACAATTGAGTTATACACGCAGTG
ATCAGTAACTTTGTGCTTGCGACC -> TCAGTAACTTTGTGCTTGCGACCC
AGGACTAGATGCCGAGCGTACGTC -> GGACTAGATGCCGAGCGTACGTCA
CTGTTATGAACCGCAGTACTAACA -> TGTTATGAACCGCAGTACTAACAA
ATCATCCTCAGGTTGTGGGGTCAC -> TCATCCTCAGGTTGTGGGGTCACC
GGAATGCCTGAATATGTACGACGG -> GAATGCCTGAATATGTACGACGGC
GAATCACTGCTAGTAGTAACAAGT -> AATCACTGCTAGTAGTAACAAGTA
AACCACCTTTTTCGGAGTTGGACT -> ACCACCTTTTTCGGAGTTGGACTT
CCACTTCTTTAGTAAAGACCTATT -> CACTTCTTTAGTAAAGACCTATTT
GTTATGAACCGCAGTACTAACAAT -> TTATGAACCGCAGTACTAACAATT
CTATACTCACAACATTAAGACTAT -> TATACTCACAACATTAAGACTATG
GTAGGAAGGCTAACATCATCCTCA -> TAGGAAGGCTAACATCATCCTCAG
GTCAACGTATTCCTTCTAAAGCTG -> TCAACGTATTCCTTCTAAAGCTGA
GGACATGAATGACCCTAACTACAG -> GACATGAATGACCCTAACTACAGC
TGGGACCGCCCACAGACACATTAA -> GGGACCGCCCACAGACACATTAAA
CAGCGCGTTCGTAAAACAATCGCT -> AGCGCGTTCGTAAAACAATCGCTC
TTTGACTTATTCATCAGTAACTTT -> TTGACTTATTCATCAGTAACTTTG
CAATTTGACTTATTCATCAGTAAC -> AATTTGACTTATTCATCAGTAACT
TAGCAAGAACTGAGGCGAGACTGC -> AGCAAGAACTGAGGCGAGACTGCA
AACAGTGTACATTCTGTTCATAAA -> ACAGTGTACATTCTGTTCATAAAA
CCAGTATATCGAGGGAATTATGCA -> CAGTATATCGAGGGAATTATGCAA
GGACAAAGGGTCCACGAGAACGGG -> GACAAAGGGTCCACGAGAACGGGC
TTGCATACTAGGTGCTCTCTATAG -> TGCATACTAGGTGCTCTCTATAGC
GCTATGACTGGCTTCATTGGCGGA -> CTATGACTGGCTTCATTGGCGGAA
ATTAAGACTATGTATTTAGAGTTG -> TTAAGACTATGTATTTAGAGTTGA
ATAGATTGTGACGTTATTAGTCAT -> TAGATTGTGACGTTATTAGTCATC
TTGTGTTACTGGGAGGTAATAAAA -> TGTGTTACTGGGAGGTAATAAAAC
TAAGGTATTTATCCTCCCCTACGA -> AAGGTATTTATCCTCCCCTACGAA
ATGTCGAGTATCATTCAAAAGTTG -> TGTCGAGTATCATTCAAAAGTTGT
ATTACCGCGCATCTTGATGAGCCC -> TTACCGCGCATCTTGATGAGCCCC
ACCGGATTAGTAATTGTCTAGCGA -> CCGGATTAGTAATTGTCTAGCGAA
TGACTTATTCATCAGTAACTTTGT -> GACTTATTCATCAGTAACTTTGTG
TGCAATGCAGGGCCTTGGCTAGGC -> GCAATGCAGGGCCTTGGCTAGGCA
CGTTCGTAAAACAATCGCTCAACA -> GTTCGTAAAACAATCGCTCAACAT
GCGGCCTCGGCATTCTCAATCCAG -> CGGCCTCGGCATTCTCAATCCAGA
CTACCAACAAATTAATATTGGACG -> TACCAACAAATTAATATTGGACGC
GTAAGTGTGGAGACAGGCTCCCTC -> TAAGTGTGGAGACAGGCTCCCTCC
TCGTAACAGCGATAATGGCTCTGA -> CGTAACAGCGATAATGGCTCTGAT
GCTCCCGCAGGCCTTTAACTCGTA -> CTCCCGCAGGCCTTTAACTCGTAA
AAGAGGAAGGCACTATAGCTTCGA -> AGAGGAAGGCACTATAGCTTCGAA
CCGCAGGCCTTTAACTCGTAACAG -> CGCAGGCCTTTAACTCGTAACAGC
TCTAGCGAACCATCCTCATAGCAA -> CTAGCGAACCATCCTCATAGCAAG
AGGTGTTGGTCTTTTCTATGCGGT -> GGTGTTGGTCTTTTCTATGCGGTG
CAAGAACTGAGGCGAGACTGCATG -> AAGAACTGAGGCGAGACTGCATGA
AAAGGGTCCACGAGAACGGGCGCA -> AAGGGTCCACGAGAACGGGCGCAC
ATTCAAAAGTTGTCAACGTATTCC -> TTCAAAAGTTGTCAACGTATTCCT
CCGCTACCAACAAATTAATATTGG -> CGCTACCAACAAATTAATATTGGA
GGAATCACTGCTAGTAGTAACAAG -> GAATCACTGCTAGTAGTAACAAGT
AAAGTAGTGCATAGAGTAACTCCG -> AAGTAGTGCATAGAGTAACTCCGG
ATGCAATTTGACTTATTCATCAGT -> TGCAATTTGACTTATTCATCAGTA
ATTGATTGCATACTAGGTGCTCTC -> TTGATTGCATACTAGGTGCTCTCT
TCAAGTAGCAGGCTGTTGAGCAAT -> CAAGTAGCAGGCTGTTGAGCAATA
GAGGATGCGCTTGGAAAATCTTGT -> AGGATGCGCTTGGAAAATCTTGTT
TTTCTCGTTGCTGCCATGGAGCGT -> TTCTCGTTGCTGCCATGGAGCGTA
ATAATGGCTCTGATCTGACTTTAG -> TAATGGCTCTGATCTGACTTTAGC
TCCCACTTATTTAAGACTACCGAT -> CCCACTTATTTAAGACTACCGATT
GGGACTAGGACGGAATCGACGACG -> GGACTAGGACGGAATCGACGACGA
GTAGCAGGCTGTTGAGCAATAGAT -> TAGCAGGCTGTTGAGCAATAGATT
AATTGTCTAGCGAACCATCCTCAT -> ATTGTCTAGCGAACCATCCTCATA
TCATCCCGAGGACTAGATGCCGAG -> CATCCCGAGGACTAGATGCCGAGC
AGCGAACCATCCTCATAGCAAGGA -> GCGAACCATCCTCATAGCAAGGAT
GACTGCATGACATCATCCCGAGGA -> ACTGCATGACATCATCCCGAGGAC
TCCCCTACGAAGGACACGACGAGC -> CCCCTACGAAGGACACGACGAGCA
TACCGATTAATAACAGGGGTTACA -> ACCGATTAATAACAGGGGTTACAG
GACTAGGACGGAATCGACGACGAG -> ACTAGGACGGAATCGACGACGAGA
GCATGACATCATCCCGAGGACTAG -> CATGACATCATCCCGAGGACTAGA
TAACAAGTACGACTGGGCGGCTCG -> AACAAGTACGACTGGGCGGCTCGG
CGGAATGCCTGAATATGTACGACG -> GGAATGCCTGAATATGTACGACGG
TCTGATCTGACTTTAGCCGTGGTC -> CTGATCTGACTTTAGCCGTGGTCC
TGATCTGACTTTAGCCGTGGTCCA -> GATCTGACTTTAGCCGTGGTCCAC
TGAATGACCCTAACTACAGCTCCC -> GAATGACCCTAACTACAGCTCCCG
TCGAAAGTCAGCCGAACGGCAACC -> CGAAAGTCAGCCGAACGGCAACCA
GCATTCGCAATTGATATTTTATTA -> CATTCGCAATTGATATTTTATTAG
TGATTGCATACTAGGTGCTCTCTA -> GATTGCATACTAGGTGCTCTCTAT
TTATTAGTCATCTGGTTGTGTTAC -> TATTAGTCATCTGGTTGTGTTACT
CTCTCTATAGCGCCCCCTAAATGA -> TCTCTATAGCGCCCCCTAAATGAT
CCCTTACCAATCTAGAAGTGATCA -> CCTTACCAATCTAGAAGTGATCAA
AACTAAGGTATTTATCCTCCCCTA -> ACTAAGGTATTTATCCTCCCCTAC
ATTCGAAAGAAGCTAAATTCAGAT -> TTCGAAAGAAGCTAAATTCAGATT
TATGCAATGCAGGGCCTTGGCTAG -> ATGCAATGCAGGGCCTTGGCTAGG
CAATCTAGAAGTGATCAACCCGCT -> AATCTAGAAGTGATCAACCCGCTA
TTTGTCAGCAGCACAACTAAGGTA -> TTGTCAGCAGCACAACTAAGGTAT
AAGTACGACTGGGCGGCTCGGTGC -> AGTACGACTGGGCGGCTCGGTGCA
ATGATGACCTATATGTAACTCTTT -> TGATGACCTATATGTAACTCTTTC
TAACGCGCGGCCTCGGCATTCTCA -> AACGCGCGGCCTCGGCATTCTCAA
CAGCACAACTAAGGTATTTATCCT -> AGCACAACTAAGGTATTTATCCTC
ACTAGGTGCTCTCTATAGCGCCCC -> CTAGGTGCTCTCTATAGCGCCCCC
ACACATTAAAGTAGTGCATAGAGT -> CACATTAAAGTAGTGCATAGAGTA
ACAATTGAGTTATACACGCAGTGG -> CAATTGAGTTATACACGCAGTGGG
AGGGCCTTGGCTAGGCACTATTAC -> GGGCCTTGGCTAGGCACTATTACC
CTGGTTGTGTTACTGGGAGGTAAT -> TGGTTGTGTTACTGGGAGGTAATA
CAATTCGTTTATGTCGTGGGTAGC -> AATTCGTTTATGTCGTGGGTAGCG
CTCATAAAGGCAGGTGTACTAAGG -> TCATAAAGGCAGGTGTACTAAGGC
ACCGGTCCATTCACCTTGTCGCGC -> CCGGTCCATTCACCTTGTCGCGCT
GCCACCAAACCGGTGGAACACGCA -> CCACCAAACCGGTGGAACACGCAT
TCGGGTTGATTGATTGCATACTAG -> CGGGTTGATTGATTGCATACTAGG
AGCAATAGATTGTGACGTTATTAG -> GCAATAGATTGTGACGTTATTAGT
AGTTGTCAACGTATTCCTTCTAAA -> GTTGTCAACGTATTCCTTCTAAAG
AGATGGTTGAGGGGCCCGACTCAT -> GATGGTTGAGGGGCCCGACTCATA
ATCCTTTCTCGTTGCTGCCATGGA -> TCCTTTCTCGTTGCTGCCATGGAG
TGTTGGTCTTTTCTATGCGGTGCA -> GTTGGTCTTTTCTATGCGGTGCAG
GATTCCTCATTATAGTTGGAACCA -> ATTCCTCATTATAGTTGGAACCAG
ACGGCATTCGCAATTGATATTTTA -> CGGCATTCGCAATTGATATTTTAT
ACTGGGAGGTAATAAAACAGACAT -> CTGGGAGGTAATAAAACAGACATT
CAGAGGATGCGCTTGGAAAATCTT -> AGAGGATGCGCTTGGAAAATCTTG
AATCCTAATCCTATTAGCCCAGCG -> ATCCTAATCCTATTAGCCCAGCGG
GAGGCGAGACTGCATGACATCATC -> AGGCGAGACTGCATGACATCATCC
TGGGTAAGTGTGGAGACAGGCTCC -> GGGTAAGTGTGGAGACAGGCTCCC
AATAGATTGTGACGTTATTAGTCA -> ATAGATTGTGACGTTATTAGTCAT
CAGTATATCGAGGGAATTATGCAA -> AGTATATCGAGGGAATTATGCAAT
GGGTGCAGAACGGCATTCGCAATT -> GGTGCAGAACGGCATTCGCAATTG
CAATTGATATTTTATTAGTTGACA -> AATTGATATTTTATTAGTTGACAA
AGTAGAGGGGCTATTCTCTAGCAA -> GTAGAGGGGCTATTCTCTAGCAAG
ATCGAGGGAATTATGCAATTTGAC -> TCGAGGGAATTATGCAATTTGACT
ACGGCCTTCAATGTCGTGGGGACT -> CGGCCTTCAATGTCGTGGGGACTA
GGGCATGTCGAGTATCATTCAAAA -> GGCATGTCGAGTATCATTCAAAAG
ATCCAGAAGCTGCCTCAAGTAGCA -> TCCAGAAGCTGCCTCAAGTAGCAG
CGAACGGCAACCACCTTTTTCGGA -> GAACGGCAACCACCTTTTTCGGAG
AGTGCATAGAGTAACTCCGGCCAC -> GTGCATAGAGTAACTCCGGCCACC
GACACGACGAGCACGTCGGTCTTG -> ACACGACGAGCACGTCGGTCTTGT
CTAATCCTATTAGCCCAGCGGACA -> TAATCCTATTAGCCCAGCGGACAA
CCTATTTGTAATTTGGGGTGGCAC -> CTATTTGTAATTTGGGGTGGCACA
TAAGTGTGGAGACAGGCTCCCTCC -> AAGTGTGGAGACAGGCTCCCTCCT
TTAGCCAAAGTAGTTGGGAGTGGT -> TAGCCAAAGTAGTTGGGAGTGGTT
TGTAACTCTTTCTGCGTTAGACAG -> GTAACTCTTTCTGCGTTAGACAGC
TTTAAGACTACCGATTAATAACAG -> TTAAGACTACCGATTAATAACAGG
GTTGAGCAATAGATTGTGACGTTA -> TTGAGCAATAGATTGTGACGTTAT
GTCGGTCTTGTGAATCGCTGTTAT -> TCGGTCTTGTGAATCGCTGTTATG
CATTCGCAATTGATATTTTATTAG -> ATTCGCAATTGATATTTTATTAGT
TATTAGCCCAGCGGACAAAGGGTC -> ATTAGCCCAGCGGACAAAGGGTCC
TTAGACAGCGTTATGCTGGATCGT -> TAGACAGCGTTATGCTGGATCGTA
ATTCTCTAGCAAGAACTGAGGCGA -> TTCTCTAGCAAGAACTGAGGCGAG
CAAAGGCAAAGATAGATGGTTGAG -> AAAGGCAAAGATAGATGGTTGAGG
ACTGTGGGGCCTCTGGTTTTCCAG -> CTGTGGGGCCTCTGGTTTTCCAGC
CGCTTGGAAAATCTTGTTTTGTCA -> GCTTGGAAAATCTTGTTTTGTCAG
TGCTGGATCGTAAATCCTAATCCT -> GCTGGATCGTAAATCCTAATCCTA
AGTTGACAAGGTGTTGGTCTTTTC -> GTTGACAAGGTGTTGGTCTTTTCT
TTGGAAAATCTTGTTTTGTCAGTA -> TGGAAAATCTTGTTTTGTCAGTAT
AAGTAGTGCATAGAGTAACTCCGG -> AGTAGTGCATAGAGTAACTCCGGC
CAGCCGAACGGCAACCACCTTTTT -> AGCCGAACGGCAACCACCTTTTTC
TTCCCCCCCTCAAGGCCTGTAGTA -> TCCCCCCCTCAAGGCCTGTAGTAG
GGGATTCCTCATTATAGTTGGAAC -> GGATTCCTCATTATAGTTGGAACC
TATCGAGGGAATTATGCAATTTGA -> ATCGAGGGAATTATGCAATTTGAC
CTAGTAGTAACAAGTACGACTGGG -> TAGTAGTAACAAGTACGACTGGGC
GTGGGGCCTCTGGTTTTCCAGCTC -> TGGGGCCTCTGGTTTTCCAGCTCG
GGGTGAGACATCGAAAGTCAGCCG -> GGTGAGACATCGAAAGTCAGCCGA
ACTCGCGTTCGTCCTTGTCACATG -> CTCGCGTTCGTCCTTGTCACATGA
TAAAGTAGTGCATAGAGTAACTCC -> AAAGTAGTGCATAGAGTAACTCCG
TCTTGGAGCGGCAAGATCAATATG -> CTTGGAGCGGCAAGATCAATATGC
GGTTGCGGGGCATGTCGAGTATCA -> GTTGCGGGGCATGTCGAGTATCAT
ATTAAAGTAGTGCATAGAGTAACT -> TTAAAGTAGTGCATAGAGTAACTC
CCAATCTAGAAGTGATCAACCCGC -> CAATCTAGAAGTGATCAACCCGCT
GTCCTTGTCACATGACTCACCGGT -> TCCTTGTCACATGACTCACCGGTC
CATCCCGAGGACTAGATGCCGAGC -> ATCCCGAGGACTAGATGCCGAGCG
CAAAGGGTCCACGAGAACGGGCGC -> AAAGGGTCCACGAGAACGGGCGCA
AAGCTGAGCCTATTCAGAGGATGC -> AGCTGAGCCTATTCAGAGGATGCG
TACGTCAAAGGCAAAGATAGATGG -> ACGTCAAAGGCAAAGATAGATGGT
GCTGAGCCTATTCAGAGGATGCGC -> CTGAGCCTATTCAGAGGATGCGCT
CTTTAACTCGTAACAGCGATAATG -> TTTAACTCGTAACAGCGATAATGG
ATTGTGACGTTATTAGTCATCTGG -> TTGTGACGTTATTAGTCATCTGGT
TATGTCGTGGGTAGCGTAACGGCC -> ATGTCGTGGGTAGCGTAACGGCCT
CAGAAGCTGCCTCAAGTAGCAGGC -> AGAAGCTGCCTCAAGTAGCAGGCT
GGTTGTGGGGTCACCTTTAACAGT -> GTTGTGGGGTCACCTTTAACAGTG
CTCGTAACAGCGATAATGGCTCTG -> TCGTAACAGCGATAATGGCTCTGA
CGACGACGAGAGGCGTGCCGTGCC -> GACGACGAGAGGCGTGCCGTGCCT
GCCGTGCCTTGGCTAACGCGTCTC -> CCGTGCCTTGGCTAACGCGTCTCG
ACTAAGGCGTGTTAGCCAAAGTAG -> CTAAGGCGTGTTAGCCAAAGTAGT
GCGTACGTCAAAGGCAAAGATAGA -> CGTACGTCAAAGGCAAAGATAGAT
AGTACTAACAATTGAGTTATACAC -> GTACTAACAATTGAGTTATACACG
CGACGAGAGGCGTGCCGTGCCTTG -> GACGAGAGGCGTGCCGTGCCTTGG
TTCTATGCGGTGCAGTAACTCGCG -> TCTATGCGGTGCAGTAACTCGCGT
AGCAAGGATATAACCCCAGCGCGT -> GCAAGGATATAACCCCAGCGCGTT
CGTATTCCTTCTAAAGCTGAGCCT -> GTATTCCTTCTAAAGCTGAGCCTA
ACGAGAACGGGCGCACCCCTATAC -> CGAGAACGGGCGCACCCCTATACT
GCTCAGTTTCCCACTTATTTAAGA -> CTCAGTTTCCCACTTATTTAAGAC
TGTCACATGACTCACCGGTCCATT -> GTCACATGACTCACCGGTCCATTC
GTCGAGTATCATTCAAAAGTTGTC -> TCGAGTATCATTCAAAAGTTGTCA
TTCCCACTTATTTAAGACTACCGA -> TCCCACTTATTTAAGACTACCGAT
AAGGCACTATAGCTTCGAACGGGA -> AGGCACTATAGCTTCGAACGGGAA
ATGCGGTGCAGTAACTCGCGTTCG -> TGCGGTGCAGTAACTCGCGTTCGT
CTAAGGTATTTATCCTCCCCTACG -> TAAGGTATTTATCCTCCCCTACGA
TATCATTCAAAAGTTGTCAACGTA -> ATCATTCAAAAGTTGTCAACGTAT
ACCAACAAATTAATATTGGACGCG -> CCAACAAATTAATATTGGACGCGC
GAATTATGCAATTTGACTTATTCA -> AATTATGCAATTTGACTTATTCAT
GGCTAGGCATCCTTGCCCGGAATG -> GCTAGGCATCCTTGCCCGGAATGC
GGGTGGCACATGCTTAGTCGCACA -> GGTGGCACATGCTTAGTCGCACAA
GCGATTTTGTCAGCAGCACAACTA -> CGATTTTGTCAGCAGCACAACTAA
GGAACACGCATAAGAGGAAGGCAC -> GAACACGCATAAGAGGAAGGCACT
GGGCCTTGGCTAGGCACTATTACC -> GGCCTTGGCTAGGCACTATTACCG
AAAGTTGTCAACGTATTCCTTCTA -> AAGTTGTCAACGTATTCCTTCTAA
CTTGGAGCGGCAAGATCAATATGC -> TTGGAGCGGCAAGATCAATATGCA
GTCACCTTTAACAGTGTACATTCT -> TCACCTTTAACAGTGTACATTCTG
ACTTTGTGCTTGCGACCCCTTACC -> CTTTGTGCTTGCGACCCCTTACCA
TATGCAATTTGACTTATTCATCAG -> ATGCAATTTGACTTATTCATCAGT
ACTGCATGACATCATCCCGAGGAC -> CTGCATGACATCATCCCGAGGACT
CAGTGTACATTCTGTTCATAAAAA -> AGTGTACATTCTGTTCATAAAAAA
AGAACGGGCGCACCCCTATACTCA -> GAACGGGCGCACCCCTATACTCAC
TTTCGATTGGAGTTGGGACCGCCC -> TTCGATTGGAGTTGGGACCGCCCA
GTGGCACATGCTTAGTCGCACAAC -> TGGCACATGCTTAGTCGCACAACT
CTCATTAACGCGCGGCCTCGGCAT -> TCATTAACGCGCGGCCTCGGCATT
TTGAGGGGGATTCCTCATTATAGT -> TGAGGGGGATTCCTCATTATAGTT
ATGCAGGGCCTTGGCTAGGCACTA -> TGCAGGGCCTTGGCTAGGCACTAT
GCGTTCGTAAAACAATCGCTCAAC -> CGTTCGTAAAACAATCGCTCAACA
CGACTCATAAAGGCAGGTGTACTA -> GACTCATAAAGGCAGGTGTACTAA
TTATCCTCCCCTACGAAGGACACG -> TATCCTCCCCTACGAAGGACACGA
CCTAATCCTATTAGCCCAGCGGAC -> CTAATCCTATTAGCCCAGCGGACA
TTAGTAAAGACCTATTTGTAATTT -> TAGTAAAGACCTATTTGTAATTTG
GCTGCCTCAAGTAGCAGGCTGTTG -> CTGCCTCAAGTAGCAGGCTGTTGA
GTTGAAACTCTTAGATTTCGATTG -> TTGAAACTCTTAGATTTCGATTGG
TTGATTGCATACTAGGTGCTCTCT -> TGATTGCATACTAGGTGCTCTCTA
TACTCACAACATTAAGACTATGTA -> ACTCACAACATTAAGACTATGTAT
TGGAGTTGGGACCGCCCACAGACA -> GGAGTTGGGACCGCCCACAGACAC
TGGTCTTGGAGCGGCAAGATCAAT -> GGTCTTGGAGCGGCAAGATCAATA
CAGGCTGTTGAGCAATAGATTGTG -> AGGCTGTTGAGCAATAGATTGTGA
ATTGAGTTATACACGCAGTGGGTG -> TTGAGTTATACACGCAGTGGGTGA
ATTAGTAATTGTCTAGCGAACCAT -> TTAGTAATTGTCTAGCGAACCATC
TATTTATCCTCCCCTACGAAGGAC -> ATTTATCCTCCCCTACGAAGGACA
AGCTAAATTCAGATTCGACCGGAT -> GCTAAATTCAGATTCGACCGGATT
TTCGATTGGAGTTGGGACCGCCCA -> TCGATTGGAGTTGGGACCGCCCAC
TGAGGGGGATTCCTCATTATAGTT -> GAGGGGGATTCCTCATTATAGTTG
GCTCTCTATAGCGCCCCCTAAATG -> CTCTCTATAGCGCCCCCTAAATGA
AAAAAACGCTAAACTGTGGGGCCT -> AAAAACGCTAAACTGTGGGGCCTC
GTCTTTTCTATGCGGTGCAGTAAC -> TCTTTTCTATGCGGTGCAGTAACT
TCCTCATTATAGTTGGAACCAGTA -> CCTCATTATAGTTGGAACCAGTAT
TAGCCCAGCGGACAAAGGGTCCAC -> AGCCCAGCGGACAAAGGGTCCACG
TTACAATGACAGAATTCTGGTCTT -> TACAATGACAGAATTCTGGTCTTG
GCGACCCCTTACCAATCTAGAAGT -> CGACCCCTTACCAATCTAGAAGTG
AACTCGTAACAGCGATAATGGCTC -> ACTCGTAACAGCGATAATGGCTCT
AGAGTAACTCCGGCCACCAAACCG -> GAGTAACTCCGGCCACCAAACCGG
GCATAAGAGGAAGGCACTATAGCT -> CATAAGAGGAAGGCACTATAGCTT
ATTGGCGGAACAGTGGGGTGCAGA -> TTGGCGGAACAGTGGGGTGCAGAA
ACTTCTTTAGTAAAGACCTATTTG -> CTTCTTTAGTAAAGACCTATTTGT
GACTATGTATTTAGAGTTGAAACT -> ACTATGTATTTAGAGTTGAAACTC
CACAACTGCGATTTTGTCAGCAGC -> ACAACTGCGATTTTGTCAGCAGCA
GTTTTCCAGCTCGGGTTGATTGAT -> TTTTCCAGCTCGGGTTGATTGATT
TTGGAGTTGGGACCGCCCACAGAC -> TGGAGTTGGGACCGCCCACAGACA
TCGCTGTTATGAACCGCAGTACTA -> CGCTGTTATGAACCGCAGTACTAA
TGTGACGTTATTAGTCATCTGGTT -> GTGACGTTATTAGTCATCTGGTTG
TGCGCTTGGAAAATCTTGTTTTGT -> GCGCTTGGAAAATCTTGTTTTGTC
CGTCAAAGGCAAAGATAGATGGTT -> GTCAAAGGCAAAGATAGATGGTTG
CGAGCACGTCGGTCTTGTGAATCG -> GAGCACGTCGGTCTTGTGAATCGC
CTGCGTTAGACAGCGTTATGCTGG -> TGCGTTAGACAGCGTTATGCTGGA
ACAGAATTCTGGTCTTGGAGCGGC -> CAGAATTCTGGTCTTGGAGCGGCA
ATGGAGCGTATGGACATGAATGAC -> TGGAGCGTATGGACATGAATGACC
GTGCATAGAGTAACTCCGGCCACC -> TGCATAGAGTAACTCCGGCCACCA
GAGTTGGACTTTTCCCCCCCTCAA -> AGTTGGACTTTTCCCCCCCTCAAG
CTATTCTCTAGCAAGAACTGAGGC -> TATTCTCTAGCAAGAACTGAGGCG
GTGTACTAAGGCGTGTTAGCCAAA -> TGTACTAAGGCGTGTTAGCCAAAG
GCGAGACTGCATGACATCATCCCG -> CGAGACTGCATGACATCATCCCGA
CCTATACTCACAACATTAAGACTA -> CTATACTCACAACATTAAGACTAT
GTTTCCCACTTATTTAAGACTACC -> TTTCCCACTTATTTAAGACTACCG
GCCTTGGCTAGGCACTATTACCGC -> CCTTGGCTAGGCACTATTACCGCG
CAGCGTTATGCTGGATCGTAAATC -> AGCGTTATGCTGGATCGTAAATCC
TGGAGCGTATGGACATGAATGACC -> GGAGCGTATGGACATGAATGACCC
CATCCTCATAGCAAGGATATAACC -> ATCCTCATAGCAAGGATATAACCC
ATCGCTGTTATGAACCGCAGTACT -> TCGCTGTTATGAACCGCAGTACTA
TTGCTGCCATGGAGCGTATGGACA -> TGCTGCCATGGAGCGTATGGACAT
CGCGTCTCGCTCAGTTTCCCACTT -> GCGTCTCGCTCAGTTTCCCACTTA
AGTAATTGTCTAGCGAACCATCCT -> GTAATTGTCTAGCGAACCATCCTC
CGGAGTTGGACTTTTCCCCCCCTC -> GGAGTTGGACTTTTCCCCCCCTCA
CCGCCCACAGACACATTAAAGTAG -> CGCCCACAGACACATTAAAGTAGT
TTAGAGTTGAAACTCTTAGATTTC -> TAGAGTTGAAACTCTTAGATTTCG
AAATCCTAATCCTATTAGCCCAGC -> AATCCTAATCCTATTAGCCCAGCG
TCTAAAGCTGAGCCTATTCAGAGG -> CTAAAGCTGAGCCTATTCAGAGGA
CTCCTCCGGGGCTAGGCATCCTTG -> TCCTCCGGGGCTAGGCATCCTTGC
CCCCTATACTCACAACATTAAGAC -> CCCTATACTCACAACATTAAGACT
AATGCCTGAATATGTACGACGGCC -> ATGCCTGAATATGTACGACGGCCA
TGGTTGGGTAAGTGTGGAGACAGG -> GGTTGGGTAAGTGTGGAGACAGGC
ACTATTACCGCGCATCTTGATGAG -> CTATTACCGCGCATCTTGATGAGC
ACCTATTTGTAATTTGGGGTGGCA -> CCTATTTGTAATTTGGGGTGGCAC
CATCAGTAACTTTGTGCTTGCGAC -> ATCAGTAACTTTGTGCTTGCGACC
GGCAAAGATAGATGGTTGAGGGGC -> GCAAAGATAGATGGTTGAGGGGCC
TGGGCGGCTCGGTGCAATTCGTTT -> GGGCGGCTCGGTGCAATTCGTTTA
ACCAATCTAGAAGTGATCAACCCG -> CCAATCTAGAAGTGATCAACCCGC
CAACCACCTTTTTCGGAGTTGGAC -> AACCACCTTTTTCGGAGTTGGACT
CTTACCAATCTAGAAGTGATCAAC -> TTACCAATCTAGAAGTGATCAACC
GGCACATGCTTAGTCGCACAACTG -> GCACATGCTTAGTCGCACAACTGC
GGTCACCTTTAACAGTGTACATTC -> GTCACCTTTAACAGTGTACATTCT
AGAGTTGAAACTCTTAGATTTCGA -> GAGTTGAAACTCTTAGATTTCGAT
GATATAACCCCAGCGCGTTCGTAA -> ATATAACCCCAGCGCGTTCGTAAA
CGCAATTGATATTTTATTAGTTGA -> GCAATTGATATTTTATTAGTTGAC
ATTCCTCATTATAGTTGGAACCAG -> TTCCTCATTATAGTTGGAACCAGT
ACTTTGAGGGGGATTCCTCATTAT -> CTTTGAGGGGGATTCCTCATTATA
GTGCCTTGGCTAACGCGTCTCGCT -> TGCCTTGGCTAACGCGTCTCGCTC
CATCTTGATGAGCCCCCGATCACC -> ATCTTGATGAGCCCCCGATCACCT
TTCCTTCTAAAGCTGAGCCTATTC -> TCCTTCTAAAGCTGAGCCTATTCA
TTTAGCCGTGGTCCACTTCTTTAG -> TTAGCCGTGGTCCACTTCTTTAGT
CTGCATGACATCATCCCGAGGACT -> TGCATGACATCATCCCGAGGACTA
GATGAGCCCCCGATCACCTAACGC -> ATGAGCCCCCGATCACCTAACGCT
AAAAGTTGTCAACGTATTCCTTCT -> AAAGTTGTCAACGTATTCCTTCTA
CGTTCGTCCTTGTCACATGACTCA -> GTTCGTCCTTGTCACATGACTCAC
GCAACCACCTTTTTCGGAGTTGGA -> CAACCACCTTTTTCGGAGTTGGAC
TGCTTAGTCGCACAACTGCGATTT -> GCTTAGTCGCACAACTGCGATTTT
CCTCATTATAGTTGGAACCAGTAT -> CTCATTATAGTTGGAACCAGTATA
GCGAACCATCCTCATAGCAAGGAT -> CGAACCATCCTCATAGCAAGGATA
GGCCACATTCGAAAGAAGCTAAAT -> GCCACATTCGAAAGAAGCTAAATT
ACTCATAAAGGCAGGTGTACTAAG -> CTCATAAAGGCAGGTGTACTAAGG
CGGCCACCAAACCGGTGGAACACG -> GGCCACCAAACCGGTGGAACACGC
ATAGCGCCCCCTAAATGATGACCT -> TAGCGCCCCCTAAATGATGACCTA
TCCGGCCACCAAACCGGTGGAACA -> CCGGCCACCAAACCGGTGGAACAC
TCTGGTTTTCCAGCTCGGGTTGAT -> CTGGTTTTCCAGCTCGGGTTGATT
CCCCTCAAGGCCTGTAGTAGGAAG -> CCCTCAAGGCCTGTAGTAGGAAGG
TTACCAATCTAGAAGTGATCAACC -> TACCAATCTAGAAGTGATCAACCC
GGTGTTGGTCTTTTCTATGCGGTG -> GTGTTGGTCTTTTCTATGCGGTGC
GACCGGATTAGTAATTGTCTAGCG -> ACCGGATTAGTAATTGTCTAGCGA
CAGGCTCCCTCCTCCGGGGCTAGG -> AGGCTCCCTCCTCCGGGGCTAGGC
AACCGGTGGAACACGCATAAGAGG -> ACCGGTGGAACACGCATAAGAGGA
CAAACCGGTGGAACACGCATAAGA -> AAACCGGTGGAACACGCATAAGAG
GACTTTAGCCGTGGTCCACTTCTT -> ACTTTAGCCGTGGTCCACTTCTTT
ATACTAGGTGCTCTCTATAGCGCC -> TACTAGGTGCTCTCTATAGCGCCC
GCAATGCAGGGCCTTGGCTAGGCA -> CAATGCAGGGCCTTGGCTAGGCAC
CGCGCAGGGATTGGTTGCGGGGCA -> GCGCAGGGATTGGTTGCGGGGCAT
AGTGGGGTGCAGAACGGCATTCGC -> GTGGGGTGCAGAACGGCATTCGCA
CTTCTAAAGCTGAGCCTATTCAGA -> TTCTAAAGCTGAGCCTATTCAGAG
CCTCGGCATTCTCAATCCAGAAGC -> CTCGGCATTCTCAATCCAGAAGCT
ATACTTTGAGGGGGATTCCTCATT -> TACTTTGAGGGGGATTCCTCATTA
TCATTGGCGGAACAGTGGGGTGCA -> CATTGGCGGAACAGTGGGGTGCAG
ACTATAGCTTCGAACGGGAATCAC -> CTATAGCTTCGAACGGGAATCACT
TCCAGAAGCTGCCTCAAGTAGCAG -> CCAGAAGCTGCCTCAAGTAGCAGG
CGTCCTTGTCACATGACTCACCGG -> GTCCTTGTCACATGACTCACCGGT
AGCTCCCGCAGGCCTTTAACTCGT -> GCTCCCGCAGGCCTTTAACTCGTA
AGAGGATGCGCTTGGAAAATCTTG -> GAGGATGCGCTTGGAAAATCTTGT
GGACCGCCCACAGACACATTAAAG -> GACCGCCCACAGACACATTAAAGT
CCCCCTAAATGATGACCTATATGT -> CCCCTAAATGATGACCTATATGTA
AAGTAGTTGGGAGTGGTTGGGTAA -> AGTAGTTGGGAGTGGTTGGGTAAG
ATCCTCATAGCAAGGATATAACCC -> TCCTCATAGCAAGGATATAACCCC
CTAGCGAACCATCCTCATAGCAAG -> TAGCGAACCATCCTCATAGCAAGG
ATCCTCCCCTACGAAGGACACGAC -> TCCTCCCCTACGAAGGACACGACG
TGGTCCACTTCTTTAGTAAAGACC -> GGTCCACTTCTTTAGTAAAGACCT
TCGTAAAACAATCGCTCAACATTA -> CGTAAAACAATCGCTCAACATTAC
CGGCCTTCAATGTCGTGGGGACTA -> GGCCTTCAATGTCGTGGGGACTAG
TATTCAGAGGATGCGCTTGGAAAA -> ATTCAGAGGATGCGCTTGGAAAAT
GTTCGTCCTTGTCACATGACTCAC -> TTCGTCCTTGTCACATGACTCACC
CGCTCAGTTTCCCACTTATTTAAG -> GCTCAGTTTCCCACTTATTTAAGA
AGCCCCCGATCACCTAACGCTATG -> GCCCCCGATCACCTAACGCTATGA
CACTGCTAGTAGTAACAAGTACGA -> ACTGCTAGTAGTAACAAGTACGAC
ACAACTGCGATTTTGTCAGCAGCA -> CAACTGCGATTTTGTCAGCAGCAC
CTCAATCCAGAAGCTGCCTCAAGT -> TCAATCCAGAAGCTGCCTCAAGTA
CTTCAATGTCGTGGGGACTAGGAC -> TTCAATGTCGTGGGGACTAGGACG
GAACTGAGGCGAGACTGCATGACA -> AACTGAGGCGAGACTGCATGACAT
AACAGCGATAATGGCTCTGATCTG -> ACAGCGATAATGGCTCTGATCTGA
CCTCCCCTACGAAGGACACGACGA -> CTCCCCTACGAAGGACACGACGAG
CGTGCCGTGCCTTGGCTAACGCGT -> GTGCCGTGCCTTGGCTAACGCGTC
TTGTGCTTGCGACCCCTTACCAAT -> TGTGCTTGCGACCCCTTACCAATC
TATTCTCTAGCAAGAACTGAGGCG -> ATTCTCTAGCAAGAACTGAGGCGA
CTCGGTGCAATTCGTTTATGTCGT -> TCGGTGCAATTCGTTTATGTCGTG
TGGGGTGCAGAACGGCATTCGCAA -> GGGGTGCAGAACGGCATTCGCAAT
AACCATCCTCATAGCAAGGATATA -> ACCATCCTCATAGCAAGGATATAA
AGGCAAAGATAGATGGTTGAGGGG -> GGCAAAGATAGATGGTTGAGGGGC
AGGCGAGACTGCATGACATCATCC -> GGCGAGACTGCATGACATCATCCC
TCAACCCGCTACCAACAAATTAAT -> CAACCCGCTACCAACAAATTAATA
AAGCTGCCTCAAGTAGCAGGCTGT -> AGCTGCCTCAAGTAGCAGGCTGTT
GAGCGGCAAGATCAATATGCAATG -> AGCGGCAAGATCAATATGCAATGC
CGTGGGTAGCGTAACGGCCTTCAA -> GTGGGTAGCGTAACGGCCTTCAAT
CTAAAGCTGAGCCTATTCAGAGGA -> TAAAGCTGAGCCTATTCAGAGGAT
AATGTCGTGGGGACTAGGACGGAA -> ATGTCGTGGGGACTAGGACGGAAT
GATCTGACTTTAGCCGTGGTCCAC -> ATCTGACTTTAGCCGTGGTCCACT
AGCAGGCTGTTGAGCAATAGATTG -> GCAGGCTGTTGAGCAATAGATTGT
GACCCCTTACCAATCTAGAAGTGA -> ACCCCTTACCAATCTAGAAGTGAT
AAAGTCAGCCGAACGGCAACCACC -> AAGTCAGCCGAACGGCAACCACCT
CGGGAATCACTGCTAGTAGTAACA -> GGGAATCACTGCTAGTAGTAACAA
TCATCTGGTTGTGTTACTGGGAGG -> CATCTGGTTGTGTTACTGGGAGGT
TAATTTGGGGTGGCACATGCTTAG -> AATTTGGGGTGGCACATGCTTAGT
TGTGGGGTCACCTTTAACAGTGTA -> GTGGGGTCACCTTTAACAGTGTAC
AGAATTCTGGTCTTGGAGCGGCAA -> GAATTCTGGTCTTGGAGCGGCAAG
CTCTTTCTGCGTTAGACAGCGTTA -> TCTTTCTGCGTTAGACAGCGTTAT
AACTCCGGCCACCAAACCGGTGGA -> ACTCCGGCCACCAAACCGGTGGAA
TGTTTTGTCAGTATATCAATTTCA -> GTTTTGTCAGTATATCAATTTCAA
GATTGGTTGCGGGGCATGTCGAGT -> ATTGGTTGCGGGGCATGTCGAGTA
CTCCGGCCACCAAACCGGTGGAAC -> TCCGGCCACCAAACCGGTGGAACA
CTCCCGCAGGCCTTTAACTCGTAA -> TCCCGCAGGCCTTTAACTCGTAAC
TGGACATGAATGACCCTAACTACA -> GGACATGAATGACCCTAACTACAG
TAAAAAACGCTAAACTGTGGGGCC -> AAAAAACGCTAAACTGTGGGGCCT
AAGAAGCTAAATTCAGATTCGACC -> AGAAGCTAAATTCAGATTCGACCG
CAAAAGTTGTCAACGTATTCCTTC -> AAAAGTTGTCAACGTATTCCTTCT
GGGGTGGCACATGCTTAGTCGCAC -> GGGTGGCACATGCTTAGTCGCACA
ATTCTGGTCTTGGAGCGGCAAGAT -> TTCTGGTCTTGGAGCGGCAAGATC
CTATGTATTTAGAGTTGAAACTCT -> TATGTATTTAGAGTTGAAACTCTT
GAACCATCCTCATAGCAAGGATAT -> AACCATCCTCATAGCAAGGATATA
GTTGTCAACGTATTCCTTCTAAAG -> TTGTCAACGTATTCCTTCTAAAGC
CTAGAAGTGATCAACCCGCTACCA -> TAGAAGTGATCAACCCGCTACCAA
CGATTGGAGTTGGGACCGCCCACA -> GATTGGAGTTGGGACCGCCCACAG
CATTAAAGTAGTGCATAGAGTAAC -> ATTAAAGTAGTGCATAGAGTAACT
GTGGTCCACTTCTTTAGTAAAGAC -> TGGTCCACTTCTTTAGTAAAGACC
TTGGAGCGGCAAGATCAATATGCA -> TGGAGCGGCAAGATCAATATGCAA
GGCAGGTGTACTAAGGCGTGTTAG -> GCAGGTGTACTAAGGCGTGTTAGC
CTAAACTGTGGGGCCTCTGGTTTT -> TAAACTGTGGGGCCTCTGGTTTTC
AACAAATTAATATTGGACGCGCAG -> ACAAATTAATATTGGACGCGCAGG
CGGGCGCACCCCTATACTCACAAC -> GGGCGCACCCCTATACTCACAACA
TGACAGAATTCTGGTCTTGGAGCG -> GACAGAATTCTGGTCTTGGAGCGG
GCCCGGAATGCCTGAATATGTACG -> CCCGGAATGCCTGAATATGTACGA
TCGAGTATCATTCAAAAGTTGTCA -> CGAGTATCATTCAAAAGTTGTCAA
ATTTGACTTATTCATCAGTAACTT -> TTTGACTTATTCATCAGTAACTTT
ATCCTAATCCTATTAGCCCAGCGG -> TCCTAATCCTATTAGCCCAGCGGA
CCCCTTACCAATCTAGAAGTGATC -> CCCTTACCAATCTAGAAGTGATCA
AGCCGAACGGCAACCACCTTTTTC -> GCCGAACGGCAACCACCTTTTTCG
CAGTAGAGGGGCTATTCTCTAGCA -> AGTAGAGGGGCTATTCTCTAGCAA
GAAACTCTTAGATTTCGATTGGAG -> AAACTCTTAGATTTCGATTGGAGT
CCTTGGCTAGGCACTATTACCGCG -> CTTGGCTAGGCACTATTACCGCGC
AACAATTGAGTTATACACGCAGTG -> ACAATTGAGTTATACACGCAGTGG
TCACAACATTAAGACTATGTATTT -> CACAACATTAAGACTATGTATTTA
CTGTTCATAAAAAACGCTAAACTG -> TGTTCATAAAAAACGCTAAACTGT
TAGTAAAGACCTATTTGTAATTTG -> AGTAAAGACCTATTTGTAATTTGG
AGCGTTATGCTGGATCGTAAATCC -> GCGTTATGCTGGATCGTAAATCCT
CGGCAAGATCAATATGCAATGCAG -> GGCAAGATCAATATGCAATGCAGG
GTTGTGTTACTGGGAGGTAATAAA -> TTGTGTTACTGGGAGGTAATAAAA
TACGAAGGACACGACGAGCACGTC -> ACGAAGGACACGACGAGCACGTCG
CCGACTCATAAAGGCAGGTGTACT -> CGACTCATAAAGGCAGGTGTACTA
GGTAGCGTAACGGCCTTCAATGTC -> GTAGCGTAACGGCCTTCAATGTCG
AGTCGCACAACTGCGATTTTGTCA -> GTCGCACAACTGCGATTTTGTCAG
AGTAGTGCATAGAGTAACTCCGGC -> GTAGTGCATAGAGTAACTCCGGCC
TACTGGGAGGTAATAAAACAGACA -> ACTGGGAGGTAATAAAACAGACAT
GTAACTTTGTGCTTGCGACCCCTT -> TAACTTTGTGCTTGCGACCCCTTA
GTGGGTAGCGTAACGGCCTTCAAT -> TGGGTAGCGTAACGGCCTTCAATG
CATTCTGTTCATAAAAAACGCTAA -> ATTCTGTTCATAAAAAACGCTAAA
CGCTATGACTGGCTTCATTGGCGG -> GCTATGACTGGCTTCATTGGCGGA
AGCTGAGCCTATTCAGAGGATGCG -> GCTGAGCCTATTCAGAGGATGCGC
AGGTTGTGGGGTCACCTTTAACAG -> GGTTGTGGGGTCACCTTTAACAGT
TGTTACTGGGAGGTAATAAAACAG -> GTTACTGGGAGGTAATAAAACAGA
TAGATTTCGATTGGAGTTGGGACC -> AGATTTCGATTGGAGTTGGGACCG
CTCACCGGTCCATTCACCTTGTCG -> TCACCGGTCCATTCACCTTGTCGC
GCTCGGGTTGATTGATTGCATACT -> CTCGGGTTGATTGATTGCATACTA
GCGTTATGCTGGATCGTAAATCCT -> CGTTATGCTGGATCGTAAATCCTA
GGCGGAACAGTGGGGTGCAGAACG -> GCGGAACAGTGGGGTGCAGAACGG
CTTGGCTAACGCGTCTCGCTCAGT -> TTGGCTAACGCGTCTCGCTCAGTT
GTTGCGGGGCATGTCGAGTATCAT -> TTGCGGGGCATGTCGAGTATCATT
GTTGACAAGGTGTTGGTCTTTTCT -> TTGACAAGGTGTTGGTCTTTTCTA
GTGCAGTAACTCGCGTTCGTCCTT -> TGCAGTAACTCGCGTTCGTCCTTG
TGACTTTAGCCGTGGTCCACTTCT -> GACTTTAGCCGTGGTCCACTTCTT
TTTAGTAAAGACCTATTTGTAATT -> TTAGTAAAGACCTATTTGTAATTT
CTATGACTGGCTTCATTGGCGGAA -> TATGACTGGCTTCATTGGCGGAAC
TCGGCATTCTCAATCCAGAAGCTG -> CGGCATTCTCAATCCAGAAGCTGC
AAGACTACCGATTAATAACAGGGG -> AGACTACCGATTAATAACAGGGGT
ATCGACGACGAGAGGCGTGCCGTG -> TCGACGACGAGAGGCGTGCCGTGC
CCTAAATGATGACCTATATGTAAC -> CTAAATGATGACCTATATGTAACT
ATATGTACGACGGCCACATTCGAA -> TATGTACGACGGCCACATTCGAAA
TTTTTCGGAGTTGGACTTTTCCCC -> TTTTCGGAGTTGGACTTTTCCCCC
TGGCTCTGATCTGACTTTAGCCGT -> GGCTCTGATCTGACTTTAGCCGTG
GCAAGAACTGAGGCGAGACTGCAT -> CAAGAACTGAGGCGAGACTGCATG
TAAGAGGAAGGCACTATAGCTTCG -> AAGAGGAAGGCACTATAGCTTCGA
CAGATTCGACCGGATTAGTAATTG -> AGATTCGACCGGATTAGTAATTGT
TCGAACGGGAATCACTGCTAGTAG -> CGAACGGGAATCACTGCTAGTAGT
ATTCGCAATTGATATTTTATTAGT -> TTCGCAATTGATATTTTATTAGTT
GAAGGCTAACATCATCCTCAGGTT -> AAGGCTAACATCATCCTCAGGTTG
TGCAATTTGACTTATTCATCAGTA -> GCAATTTGACTTATTCATCAGTAA
TTATTCATCAGTAACTTTGTGCTT -> TATTCATCAGTAACTTTGTGCTTG
GTCGCACAACTGCGATTTTGTCAG -> TCGCACAACTGCGATTTTGTCAGC
ACGAAGGACACGACGAGCACGTCG -> CGAAGGACACGACGAGCACGTCGG
GTATATCGAGGGAATTATGCAATT -> TATATCGAGGGAATTATGCAATTT
ACGCAGTGGGTGAGACATCGAAAG -> CGCAGTGGGTGAGACATCGAAAGT
TTGGTCTTTTCTATGCGGTGCAGT -> TGGTCTTTTCTATGCGGTGCAGTA
GGCTAGGCACTATTACCGCGCATC -> GCTAGGCACTATTACCGCGCATCT
GGACGGAATCGACGACGAGAGGCG -> GACGGAATCGACGACGAGAGGCGT
GTTGGACTTTTCCCCCCCTCAAGG -> TTGGACTTTTCCCCCCCTCAAGGC
TATAGCTTCGAACGGGAATCACTG -> ATAGCTTCGAACGGGAATCACTGC
TTTTCTATGCGGTGCAGTAACTCG -> TTTCTATGCGGTGCAGTAACTCGC
ATCTGGTTGTGTTACTGGGAGGTA -> TCTGGTTGTGTTACTGGGAGGTAA
GCGGCTCGGTGCAATTCGTTTATG -> CGGCTCGGTGCAATTCGTTTATGT
TCATAGCAAGGATATAACCCCAGC -> CATAGCAAGGATATAACCCCAGCG
CCTCCGGGGCTAGGCATCCTTGCC -> CTCCGGGGCTAGGCATCCTTGCCC
GAGGGGCTATTCTCTAGCAAGAAC -> AGGGGCTATTCTCTAGCAAGAACT
GTCATCTGGTTGTGTTACTGGGAG -> TCATCTGGTTGTGTTACTGGGAGG
CCACCTTTTTCGGAGTTGGACTTT -> CACCTTTTTCGGAGTTGGACTTTT
GAACCAGTATATCGAGGGAATTAT -> AACCAGTATATCGAGGGAATTATG
TCAGTTTCCCACTTATTTAAGACT -> CAGTTTCCCACTTATTTAAGACTA
TGGAGCGGCAAGATCAATATGCAA -> GGAGCGGCAAGATCAATATGCAAT
TCCACGAGAACGGGCGCACCCCTA -> CCACGAGAACGGGCGCACCCCTAT
AACATTAAGACTATGTATTTAGAG -> ACATTAAGACTATGTATTTAGAGT
CATGACATCATCCCGAGGACTAGA -> ATGACATCATCCCGAGGACTAGAT
GATTTTGTCAGCAGCACAACTAAG -> ATTTTGTCAGCAGCACAACTAAGG
ATGACTGGCTTCATTGGCGGAACA -> TGACTGGCTTCATTGGCGGAACAG
ATGACCCTAACTACAGCTCCCGCA -> TGACCCTAACTACAGCTCCCGCAG
CCGAACGGCAACCACCTTTTTCGG -> CGAACGGCAACCACCTTTTTCGGA
GGTTTTCCAGCTCGGGTTGATTGA -> GTTTTCCAGCTCGGGTTGATTGAT
TAGAAGTGATCAACCCGCTACCAA -> AGAAGTGATCAACCCGCTACCAAC
TCGCTCAGTTTCCCACTTATTTAA -> CGCTCAGTTTCCCACTTATTTAAG
TGGCTTCATTGGCGGAACAGTGGG -> GGCTTCATTGGCGGAACAGTGGGG
CGCACCCCTATACTCACAACATTA -> GCACCCCTATACTCACAACATTAA
CGACGGCCACATTCGAAAGAAGCT -> GACGGCCACATTCGAAAGAAGCTA
CACCTTTAACAGTGTACATTCTGT -> ACCTTTAACAGTGTACATTCTGTT
ACCGATTAATAACAGGGGTTACAG -> CCGATTAATAACAGGGGTTACAGT
TGGCGGAACAGTGGGGTGCAGAAC -> GGCGGAACAGTGGGGTGCAGAACG
GGACACGACGAGCACGTCGGTCTT -> GACACGACGAGCACGTCGGTCTTG
GATTGCATACTAGGTGCTCTCTAT -> ATTGCATACTAGGTGCTCTCTATA
CATTATCCTTTCTCGTTGCTGCCA -> ATTATCCTTTCTCGTTGCTGCCAT
AACAATCGCTCAACATTACAATGA -> ACAATCGCTCAACATTACAATGAC
AGTTGGGAGTGGTTGGGTAAGTGT -> GTTGGGAGTGGTTGGGTAAGTGTG
AAACAATCGCTCAACATTACAATG -> AACAATCGCTCAACATTACAATGA
CCCCCTCAAGGCCTGTAGTAGGAA -> CCCCTCAAGGCCTGTAGTAGGAAG
CACCCCTATACTCACAACATTAAG -> ACCCCTATACTCACAACATTAAGA
TCTTTCTGCGTTAGACAGCGTTAT -> CTTTCTGCGTTAGACAGCGTTATG
AGTAACTTTGTGCTTGCGACCCCT -> GTAACTTTGTGCTTGCGACCCCTT
GTTGGGAGTGGTTGGGTAAGTGTG -> TTGGGAGTGGTTGGGTAAGTGTGG
CCCGATCACCTAACGCTATGACTG -> CCGATCACCTAACGCTATGACTGG
TTAACGCGCGGCCTCGGCATTCTC -> TAACGCGCGGCCTCGGCATTCTCA
TAGTGCATAGAGTAACTCCGGCCA -> AGTGCATAGAGTAACTCCGGCCAC
ACTGAGGCGAGACTGCATGACATC -> CTGAGGCGAGACTGCATGACATCA
CATCATCCTCAGGTTGTGGGGTCA -> ATCATCCTCAGGTTGTGGGGTCAC
TAGATGCCGAGCGTACGTCAAAGG -> AGATGCCGAGCGTACGTCAAAGGC
ATGTATTTAGAGTTGAAACTCTTA -> TGTATTTAGAGTTGAAACTCTTAG
CTGGTTTTCCAGCTCGGGTTGATT -> TGGTTTTCCAGCTCGGGTTGATTG
GCGTAACGGCCTTCAATGTCGTGG -> CGTAACGGCCTTCAATGTCGTGGG
TTGTGGGGTCACCTTTAACAGTGT -> TGTGGGGTCACCTTTAACAGTGTA
TAGTTGACAAGGTGTTGGTCTTTT -> AGTTGACAAGGTGTTGGTCTTTTC
TATATCAATTTCAATCAAAGAGCC -> ATATCAATTTCAATCAAAGAGCCC
CACCTTTTTCGGAGTTGGACTTTT -> ACCTTTTTCGGAGTTGGACTTTTC
ATTCAGATTCGACCGGATTAGTAA -> TTCAGATTCGACCGGATTAGTAAT
GTAGAGGGGCTATTCTCTAGCAAG -> TAGAGGGGCTATTCTCTAGCAAGA
ATTAACGCGCGGCCTCGGCATTCT -> TTAACGCGCGGCCTCGGCATTCTC
ACGAGCACGTCGGTCTTGTGAATC -> CGAGCACGTCGGTCTTGTGAATCG
TTGACAAGGTGTTGGTCTTTTCTA -> TGACAAGGTGTTGGTCTTTTCTAT
GTGGGTGAGACATCGAAAGTCAGC -> TGGGTGAGACATCGAAAGTCAGCC
CATGGAGCGTATGGACATGAATGA -> ATGGAGCGTATGGACATGAATGAC
GCTCCCTCCTCCGGGGCTAGGCAT -> CTCCCTCCTCCGGGGCTAGGCATC
TCGTCCTTGTCACATGACTCACCG -> CGTCCTTGTCACATGACTCACCGG
GCTTCGAACGGGAATCACTGCTAG -> CTTCGAACGGGAATCACTGCTAGT
AGAGGGGCTATTCTCTAGCAAGAA -> GAGGGGCTATTCTCTAGCAAGAAC
TAACTCGTAACAGCGATAATGGCT -> AACTCGTAACAGCGATAATGGCTC
TCCACTTCTTTAGTAAAGACCTAT -> CCACTTCTTTAGTAAAGACCTATT
AGACTATGTATTTAGAGTTGAAAC -> GACTATGTATTTAGAGTTGAAACT
TGCCGAGCGTACGTCAAAGGCAAA -> GCCGAGCGTACGTCAAAGGCAAAG
GTTCGTAAAACAATCGCTCAACAT -> TTCGTAAAACAATCGCTCAACATT
TGGCTAACGCGTCTCGCTCAGTTT -> GGCTAACGCGTCTCGCTCAGTTTC
GCACCCCTATACTCACAACATTAA -> CACCCCTATACTCACAACATTAAG
GCTATTCTCTAGCAAGAACTGAGG -> CTATTCTCTAGCAAGAACTGAGGC
GCAGGTGTACTAAGGCGTGTTAGC -> CAGGTGTACTAAGGCGTGTTAGCC
GCTGGATCGTAAATCCTAATCCTA -> CTGGATCGTAAATCCTAATCCTAT
CATTGGCGGAACAGTGGGGTGCAG -> ATTGGCGGAACAGTGGGGTGCAGA
AAGTAGCAGGCTGTTGAGCAATAG -> AGTAGCAGGCTGTTGAGCAATAGA
CCCGAGGACTAGATGCCGAGCGTA -> CCGAGGACTAGATGCCGAGCGTAC
GCACAACTAAGGTATTTATCCTCC -> CACAACTAAGGTATTTATCCTCCC
GTATATCAATTTCAATCAAAGAGC -> TATATCAATTTCAATCAAAGAGCC
CCGTGGTCCACTTCTTTAGTAAAG -> CGTGGTCCACTTCTTTAGTAAAGA
TGAATATGTACGACGGCCACATTC -> GAATATGTACGACGGCCACATTCG
CTCGCGTTCGTCCTTGTCACATGA -> TCGCGTTCGTCCTTGTCACATGAC
GAAGCTGCCTCAAGTAGCAGGCTG -> AAGCTGCCTCAAGTAGCAGGCTGT
CGCAGGCCTTTAACTCGTAACAGC -> GCAGGCCTTTAACTCGTAACAGCG
AGATGCCGAGCGTACGTCAAAGGC -> GATGCCGAGCGTACGTCAAAGGCA
TAGCAGGCTGTTGAGCAATAGATT -> AGCAGGCTGTTGAGCAATAGATTG
GGGGTCACCTTTAACAGTGTACAT -> GGGTCACCTTTAACAGTGTACATT
TAGATGGTTGAGGGGCCCGACTCA -> AGATGGTTGAGGGGCCCGACTCAT
GGTCTTTTCTATGCGGTGCAGTAA -> GTCTTTTCTATGCGGTGCAGTAAC
TAAGACTATGTATTTAGAGTTGAA -> AAGACTATGTATTTAGAGTTGAAA
GGGGCTAGGCATCCTTGCCCGGAA -> GGGCTAGGCATCCTTGCCCGGAAT
TATGGACATGAATGACCCTAACTA -> ATGGACATGAATGACCCTAACTAC
CGAACGGGAATCACTGCTAGTAGT -> GAACGGGAATCACTGCTAGTAGTA
CCACCAAACCGGTGGAACACGCAT -> CACCAAACCGGTGGAACACGCATA
GATTCGACCGGATTAGTAATTGTC -> ATTCGACCGGATTAGTAATTGTCT
AGCGCCCCCTAAATGATGACCTAT -> GCGCCCCCTAAATGATGACCTATA
TGCAGAACGGCATTCGCAATTGAT -> GCAGAACGGCATTCGCAATTGATA
AGCGTAACGGCCTTCAATGTCGTG -> GCGTAACGGCCTTCAATGTCGTGG
TTCGAAAGAAGCTAAATTCAGATT -> TCGAAAGAAGCTAAATTCAGATTC
GCCCTCATTAACGCGCGGCCTCGG -> CCCTCATTAACGCGCGGCCTCGGC
ATCTGACTTTAGCCGTGGTCCACT -> TCTGACTTTAGCCGTGGTCCACTT
CTCTATAGCGCCCCCTAAATGATG -> TCTATAGCGCCCCCTAAATGATGA
CAACATTACAATGACAGAATTCTG -> AACATTACAATGACAGAATTCTGG
CACGACGAGCACGTCGGTCTTGTG -> ACGACGAGCACGTCGGTCTTGTGA
TTGGGAGTGGTTGGGTAAGTGTGG -> TGGGAGTGGTTGGGTAAGTGTGGA
ATTTCAATCAAAGAGCCCTCATTA -> TTTCAATCAAAGAGCCCTCATTAA
AGGCAGGTGTACTAAGGCGTGTTA -> GGCAGGTGTACTAAGGCGTGTTAG
GGCGTGTTAGCCAAAGTAGTTGGG -> GCGTGTTAGCCAAAGTAGTTGGGA
ACAGTAGAGGGGCTATTCTCTAGC -> CAGTAGAGGGGCTATTCTCTAGCA
ATATCAATTTCAATCAAAGAGCCC -> TATCAATTTCAATCAAAGAGCCCT
GACTGGCTTCATTGGCGGAACAGT -> ACTGGCTTCATTGGCGGAACAGTG
TAAAACAGACATTATCCTTTCTCG -> AAAACAGACATTATCCTTTCTCGT
AGGGGTTACAGTAGAGGGGCTATT -> GGGGTTACAGTAGAGGGGCTATTC
CAACTGCGATTTTGTCAGCAGCAC -> AACTGCGATTTTGTCAGCAGCACA
CAGTAACTCGCGTTCGTCCTTGTC -> AGTAACTCGCGTTCGTCCTTGTCA
CGGCATTCTCAATCCAGAAGCTGC -> GGCATTCTCAATCCAGAAGCTGCC
CGAGCGTACGTCAAAGGCAAAGAT -> GAGCGTACGTCAAAGGCAAAGATA
CCTTCAATGTCGTGGGGACTAGGA -> CTTCAATGTCGTGGGGACTAGGAC
GCTAAATTCAGATTCGACCGGATT -> CTAAATTCAGATTCGACCGGATTA
TTCGCAATTGATATTTTATTAGTT -> TCGCAATTGATATTTTATTAGTTG
GACTTATTCATCAGTAACTTTGTG -> ACTTATTCATCAGTAACTTTGTGC
TCTTAGATTTCGATTGGAGTTGGG -> CTTAGATTTCGATTGGAGTTGGGA
TTCTTTAGTAAAGACCTATTTGTA -> TCTTTAGTAAAGACCTATTTGTAA
GTAACTCTTTCTGCGTTAGACAGC -> TAACTCTTTCTGCGTTAGACAGCG
AACCGCAGTACTAACAATTGAGTT -> ACCGCAGTACTAACAATTGAGTTA
TCCTAATCCTATTAGCCCAGCGGA -> CCTAATCCTATTAGCCCAGCGGAC
TCAGTATATCAATTTCAATCAAAG -> CAGTATATCAATTTCAATCAAAGA
CGGCCACATTCGAAAGAAGCTAAA -> GGCCACATTCGAAAGAAGCTAAAT
TTTGTCAGTATATCAATTTCAATC -> TTGTCAGTATATCAATTTCAATCA
TTTAACTCGTAACAGCGATAATGG -> TTAACTCGTAACAGCGATAATGGC
AATGCAGGGCCTTGGCTAGGCACT -> ATGCAGGGCCTTGGCTAGGCACTA
AATAACAGGGGTTACAGTAGAGGG -> ATAACAGGGGTTACAGTAGAGGGG
CCGGTGGAACACGCATAAGAGGAA -> CGGTGGAACACGCATAAGAGGAAG
GCCTCGGCATTCTCAATCCAGAAG -> CCTCGGCATTCTCAATCCAGAAGC
ACTGCTAGTAGTAACAAGTACGAC -> CTGCTAGTAGTAACAAGTACGACT
CCAAACCGGTGGAACACGCATAAG -> CAAACCGGTGGAACACGCATAAGA
AGCTGCCTCAAGTAGCAGGCTGTT -> GCTGCCTCAAGTAGCAGGCTGTTG
TGAATCGCTGTTATGAACCGCAGT -> GAATCGCTGTTATGAACCGCAGTA
ATCTTGTTTTGTCAGTATATCAAT -> TCTTGTTTTGTCAGTATATCAATT
CGTTATTAGTCATCTGGTTGTGTT -> GTTATTAGTCATCTGGTTGTGTTA
ATCAAAGAGCCCTCATTAACGCGC -> TCAAAGAGCCCTCATTAACGCGCG
AGGTAATAAAACAGACATTATCCT -> GGTAATAAAACAGACATTATCCTT
CGTCTCGCTCAGTTTCCCACTTAT -> GTCTCGCTCAGTTTCCCACTTATT
ATATGTAACTCTTTCTGCGTTAGA -> TATGTAACTCTTTCTGCGTTAGAC
AATGACAGAATTCTGGTCTTGGAG -> ATGACAGAATTCTGGTCTTGGAGC
TTAATATTGGACGCGCAGGGATTG -> TAATATTGGACGCGCAGGGATTGG
CTCCCCTACGAAGGACACGACGAG -> TCCCCTACGAAGGACACGACGAGC
GTTGGGACCGCCCACAGACACATT -> TTGGGACCGCCCACAGACACATTA
ACCTAACGCTATGACTGGCTTCAT -> CCTAACGCTATGACTGGCTTCATT
TTCTGTTCATAAAAAACGCTAAAC -> TCTGTTCATAAAAAACGCTAAACT
ATAACCCCAGCGCGTTCGTAAAAC -> TAACCCCAGCGCGTTCGTAAAACA
ACGTTATTAGTCATCTGGTTGTGT -> CGTTATTAGTCATCTGGTTGTGTT
GACATGAATGACCCTAACTACAGC -> ACATGAATGACCCTAACTACAGCT
AGCGGACAAAGGGTCCACGAGAAC -> GCGGACAAAGGGTCCACGAGAACG
AGTGTGGAGACAGGCTCCCTCCTC -> GTGTGGAGACAGGCTCCCTCCTCC
CCACGAGAACGGGCGCACCCCTAT -> CACGAGAACGGGCGCACCCCTATA
TACTAAGGCGTGTTAGCCAAAGTA -> ACTAAGGCGTGTTAGCCAAAGTAG
GCCCGACTCATAAAGGCAGGTGTA -> CCCGACTCATAAAGGCAGGTGTAC
CGCTCAACATTACAATGACAGAAT -> GCTCAACATTACAATGACAGAATT
TATTCCTTCTAAAGCTGAGCCTAT -> ATTCCTTCTAAAGCTGAGCCTATT
GCAATTCGTTTATGTCGTGGGTAG -> CAATTCGTTTATGTCGTGGGTAGC
GTGTTAGCCAAAGTAGTTGGGAGT -> TGTTAGCCAAAGTAGTTGGGAGTG
CACTATAGCTTCGAACGGGAATCA -> ACTATAGCTTCGAACGGGAATCAC
ATATTGGACGCGCAGGGATTGGTT -> TATTGGACGCGCAGGGATTGGTTG
CATAAAGGCAGGTGTACTAAGGCG -> ATAAAGGCAGGTGTACTAAGGCGT
AAGTTGTCAACGTATTCCTTCTAA -> AGTTGTCAACGTATTCCTTCTAAA
GGCATGTCGAGTATCATTCAAAAG -> GCATGTCGAGTATCATTCAAAAGT
CTTGGCTAGGCACTATTACCGCGC -> TTGGCTAGGCACTATTACCGCGCA
GCTAGGCACTATTACCGCGCATCT -> CTAGGCACTATTACCGCGCATCTT
AAACCGGTGGAACACGCATAAGAG -> AACCGGTGGAACACGCATAAGAGG
TTATCCTTTCTCGTTGCTGCCATG -> TATCCTTTCTCGTTGCTGCCATGG
TGGAGACAGGCTCCCTCCTCCGGG -> GGAGACAGGCTCCCTCCTCCGGGG
AAACTCTTAGATTTCGATTGGAGT -> AACTCTTAGATTTCGATTGGAGTT
CTAGGACGGAATCGACGACGAGAG -> TAGGACGGAATCGACGACGAGAGG
ACAATGACAGAATTCTGGTCTTGG -> CAATGACAGAATTCTGGTCTTGGA
TGCCTTGGCTAACGCGTCTCGCTC -> GCCTTGGCTAACGCGTCTCGCTCA
TCAGAGGATGCGCTTGGAAAATCT -> CAGAGGATGCGCTTGGAAAATCTT
AATTAATATTGGACGCGCAGGGAT -> ATTAATATTGGACGCGCAGGGATT
TATGCTGGATCGTAAATCCTAATC -> ATGCTGGATCGTAAATCCTAATCC
TGAGCCCCCGATCACCTAACGCTA -> GAGCCCCCGATCACCTAACGCTAT
CGAACCATCCTCATAGCAAGGATA -> GAACCATCCTCATAGCAAGGATAT
TCATCAGTAACTTTGTGCTTGCGA -> CATCAGTAACTTTGTGCTTGCGAC
TTTGGGGTGGCACATGCTTAGTCG -> TTGGGGTGGCACATGCTTAGTCGC
TCGCAATTGATATTTTATTAGTTG -> CGCAATTGATATTTTATTAGTTGA
TATAACCCCAGCGCGTTCGTAAAA -> ATAACCCCAGCGCGTTCGTAAAAC
TTCAGATTCGACCGGATTAGTAAT -> TCAGATTCGACCGGATTAGTAATT
ATTAATAACAGGGGTTACAGTAGA -> TTAATAACAGGGGTTACAGTAGAG
CTACAGCTCCCGCAGGCCTTTAAC -> TACAGCTCCCGCAGGCCTTTAACT
AAAAACGCTAAACTGTGGGGCCTC -> AAAACGCTAAACTGTGGGGCCTCT
AGGGATTGGTTGCGGGGCATGTCG -> GGGATTGGTTGCGGGGCATGTCGA
CATTAACGCGCGGCCTCGGCATTC -> ATTAACGCGCGGCCTCGGCATTCT
CTGGATCGTAAATCCTAATCCTAT -> TGGATCGTAAATCCTAATCCTATT
ATGCGCTTGGAAAATCTTGTTTTG -> TGCGCTTGGAAAATCTTGTTTTGT
TGTCGTGGGGACTAGGACGGAATC -> GTCGTGGGGACTAGGACGGAATCG
CATACTAGGTGCTCTCTATAGCGC -> ATACTAGGTGCTCTCTATAGCGCC
GGAGTTGGACTTTTCCCCCCCTCA -> GAGTTGGACTTTTCCCCCCCTCAA
ATGGACATGAATGACCCTAACTAC -> TGGACATGAATGACCCTAACTACA
GTGGGGTCACCTTTAACAGTGTAC -> TGGGGTCACCTTTAACAGTGTACA
GGATGCGCTTGGAAAATCTTGTTT -> GATGCGCTTGGAAAATCTTGTTTT
ATGCTTAGTCGCACAACTGCGATT -> TGCTTAGTCGCACAACTGCGATTT
TGCGTTAGACAGCGTTATGCTGGA -> GCGTTAGACAGCGTTATGCTGGAT
GCCAAAGTAGTTGGGAGTGGTTGG -> CCAAAGTAGTTGGGAGTGGTTGGG
CTTGCGACCCCTTACCAATCTAGA -> TTGCGACCCCTTACCAATCTAGAA
GGATTAGTAATTGTCTAGCGAACC -> GATTAGTAATTGTCTAGCGAACCA
TAGATTGTGACGTTATTAGTCATC -> AGATTGTGACGTTATTAGTCATCT
AGATTCGACCGGATTAGTAATTGT -> GATTCGACCGGATTAGTAATTGTC
CTAACTACAGCTCCCGCAGGCCTT -> TAACTACAGCTCCCGCAGGCCTTT
AGTATATCGAGGGAATTATGCAAT -> GTATATCGAGGGAATTATGCAATT
ATAGAGTAACTCCGGCCACCAAAC -> TAGAGTAACTCCGGCCACCAAACC
TAGCTTCGAACGGGAATCACTGCT -> AGCTTCGAACGGGAATCACTGCTA
AATCTTGTTTTGTCAGTATATCAA -> ATCTTGTTTTGTCAGTATATCAAT
ATTCGACCGGATTAGTAATTGTCT -> TTCGACCGGATTAGTAATTGTCTA
TCATTAACGCGCGGCCTCGGCATT -> CATTAACGCGCGGCCTCGGCATTC
TAAATGATGACCTATATGTAACTC -> AAATGATGACCTATATGTAACTCT
AAAACGCTAAACTGTGGGGCCTCT -> AAACGCTAAACTGTGGGGCCTCTG
CAATGCAGGGCCTTGGCTAGGCAC -> AATGCAGGGCCTTGGCTAGGCACT
CATAAAAAACGCTAAACTGTGGGG -> ATAAAAAACGCTAAACTGTGGGGC
CAATATGCAATGCAGGGCCTTGGC -> AATATGCAATGCAGGGCCTTGGCT
TTGTGAATCGCTGTTATGAACCGC -> TGTGAATCGCTGTTATGAACCGCA
CGCGCATCTTGATGAGCCCCCGAT -> GCGCATCTTGATGAGCCCCCGATC
GGGCTATTCTCTAGCAAGAACTGA -> GGCTATTCTCTAGCAAGAACTGAG
TCTTGATGAGCCCCCGATCACCTA -> CTTGATGAGCCCCCGATCACCTAA
GACGACGAGAGGCGTGCCGTGCCT -> ACGACGAGAGGCGTGCCGTGCCTT
GCTCGGTGCAATTCGTTTATGTCG -> CTCGGTGCAATTCGTTTATGTCGT
AGACATCGAAAGTCAGCCGAACGG -> GACATCGAAAGTCAGCCGAACGGC
TGGAACCAGTATATCGAGGGAATT -> GGAACCAGTATATCGAGGGAATTA
CTGAGCCTATTCAGAGGATGCGCT -> TGAGCCTATTCAGAGGATGCGCTT
TGGACTTTTCCCCCCCTCAAGGCC -> GGACTTTTCCCCCCCTCAAGGCCT
TAACAGGGGTTACAGTAGAGGGGC -> AACAGGGGTTACAGTAGAGGGGCT
GACAAAGGGTCCACGAGAACGGGC -> ACAAAGGGTCCACGAGAACGGGCG
CTTATTCATCAGTAACTTTGTGCT -> TTATTCATCAGTAACTTTGTGCTT
AGGGGCCCGACTCATAAAGGCAGG -> GGGGCCCGACTCATAAAGGCAGGT
CTTCATTGGCGGAACAGTGGGGTG -> TTCATTGGCGGAACAGTGGGGTGC
TCTGGTCTTGGAGCGGCAAGATCA -> CTGGTCTTGGAGCGGCAAGATCAA
GGTCCATTCACCTTGTCGCGCTTT -> GTCCATTCACCTTGTCGCGCTTTA
GCCTTGGCTAACGCGTCTCGCTCA -> CCTTGGCTAACGCGTCTCGCTCAG
TAAATCCTAATCCTATTAGCCCAG -> AAATCCTAATCCTATTAGCCCAGC
GGCCTTTAACTCGTAACAGCGATA -> GCCTTTAACTCGTAACAGCGATAA
CCCTCCTCCGGGGCTAGGCATCCT -> CCTCCTCCGGGGCTAGGCATCCTT
CTTTTTCGGAGTTGGACTTTTCCC -> TTTTTCGGAGTTGGACTTTTCCCC
TTGAGGGGCCCGACTCATAAAGGC -> TGAGGGGCCCGACTCATAAAGGCA
CGCGTTCGTAAAACAATCGCTCAA -> GCGTTCGTAAAACAATCGCTCAAC
GCCGAGCGTACGTCAAAGGCAAAG -> CCGAGCGTACGTCAAAGGCAAAGA
TCCTTTCTCGTTGCTGCCATGGAG -> CCTTTCTCGTTGCTGCCATGGAGC
CGTTTATGTCGTGGGTAGCGTAAC -> GTTTATGTCGTGGGTAGCGTAACG
TCAATATGCAATGCAGGGCCTTGG -> CAATATGCAATGCAGGGCCTTGGC
CAACGTATTCCTTCTAAAGCTGAG -> AACGTATTCCTTCTAAAGCTGAGC
TGTACGACGGCCACATTCGAAAGA -> GTACGACGGCCACATTCGAAAGAA
CCGATCACCTAACGCTATGACTGG -> CGATCACCTAACGCTATGACTGGC
GGGTTGATTGATTGCATACTAGGT -> GGTTGATTGATTGCATACTAGGTG
AATCAAAGAGCCCTCATTAACGCG -> ATCAAAGAGCCCTCATTAACGCGC
ACAACATTAAGACTATGTATTTAG -> CAACATTAAGACTATGTATTTAGA
TGAGTTATACACGCAGTGGGTGAG -> GAGTTATACACGCAGTGGGTGAGA
ACGGCAACCACCTTTTTCGGAGTT -> CGGCAACCACCTTTTTCGGAGTTG
GACATTATCCTTTCTCGTTGCTGC -> ACATTATCCTTTCTCGTTGCTGCC
GTGCCGTGCCTTGGCTAACGCGTC -> TGCCGTGCCTTGGCTAACGCGTCT
GCGCGTTCGTAAAACAATCGCTCA -> CGCGTTCGTAAAACAATCGCTCAA
ACCCTAACTACAGCTCCCGCAGGC -> CCCTAACTACAGCTCCCGCAGGCC
AACGCTAAACTGTGGGGCCTCTGG -> ACGCTAAACTGTGGGGCCTCTGGT
AGGTATTTATCCTCCCCTACGAAG -> GGTATTTATCCTCCCCTACGAAGG
CTTTCTGCGTTAGACAGCGTTATG -> TTTCTGCGTTAGACAGCGTTATGC
CGCAGGGATTGGTTGCGGGGCATG -> GCAGGGATTGGTTGCGGGGCATGT
TGTACTAAGGCGTGTTAGCCAAAG -> GTACTAAGGCGTGTTAGCCAAAGT
GTAGTGCATAGAGTAACTCCGGCC -> TAGTGCATAGAGTAACTCCGGCCA
CGCTGTTATGAACCGCAGTACTAA -> GCTGTTATGAACCGCAGTACTAAC
ACCCCTTACCAATCTAGAAGTGAT -> CCCCTTACCAATCTAGAAGTGATC
ATTACAATGACAGAATTCTGGTCT -> TTACAATGACAGAATTCTGGTCTT
GGGAGGTAATAAAACAGACATTAT -> GGAGGTAATAAAACAGACATTATC
CGTACGTCAAAGGCAAAGATAGAT -> GTACGTCAAAGGCAAAGATAGATG
TACAGTAGAGGGGCTATTCTCTAG -> ACAGTAGAGGGGCTATTCTCTAGC
GACGGAATCGACGACGAGAGGCGT -> ACGGAATCGACGACGAGAGGCGTG
TCGGAGTTGGACTTTTCCCCCCCT -> CGGAGTTGGACTTTTCCCCCCCTC
ACGGGCGCACCCCTATACTCACAA -> CGGGCGCACCCCTATACTCACAAC
TACGACTGGGCGGCTCGGTGCAAT -> ACGACTGGGCGGCTCGGTGCAATT
GATGCGCTTGGAAAATCTTGTTTT -> ATGCGCTTGGAAAATCTTGTTTTG
GCACTATTACCGCGCATCTTGATG -> CACTATTACCGCGCATCTTGATGA
TTAACTCGTAACAGCGATAATGGC -> TAACTCGTAACAGCGATAATGGCT
GGATTGGTTGCGGGGCATGTCGAG -> GATTGGTTGCGGGGCATGTCGAGT
GCAGGCTGTTGAGCAATAGATTGT -> CAGGCTGTTGAGCAATAGATTGTG
AGGTGCTCTCTATAGCGCCCCCTA -> GGTGCTCTCTATAGCGCCCCCTAA
CCTCAGGTTGTGGGGTCACCTTTA -> CTCAGGTTGTGGGGTCACCTTTAA
CTTTGAGGGGGATTCCTCATTATA -> TTTGAGGGGGATTCCTCATTATAG
TCACCGGTCCATTCACCTTGTCGC -> CACCGGTCCATTCACCTTGTCGCG
TCTTGTGAATCGCTGTTATGAACC -> CTTGTGAATCGCTGTTATGAACCG
CAATCGCTCAACATTACAATGACA -> AATCGCTCAACATTACAATGACAG
ACATCGAAAGTCAGCCGAACGGCA -> CATCGAAAGTCAGCCGAACGGCAA
AATCTAGAAGTGATCAACCCGCTA -> ATCTAGAAGTGATCAACCCGCTAC
GCCTGTAGTAGGAAGGCTAACATC -> CCTGTAGTAGGAAGGCTAACATCA
GCAGGCCTTTAACTCGTAACAGCG -> CAGGCCTTTAACTCGTAACAGCGA
ATCACTGCTAGTAGTAACAAGTAC -> TCACTGCTAGTAGTAACAAGTACG
CGTGGGGACTAGGACGGAATCGAC -> GTGGGGACTAGGACGGAATCGACG
TCTTGTTTTGTCAGTATATCAATT -> CTTGTTTTGTCAGTATATCAATTT
TATTCATCAGTAACTTTGTGCTTG -> ATTCATCAGTAACTTTGTGCTTGC
ACACGCAGTGGGTGAGACATCGAA -> CACGCAGTGGGTGAGACATCGAAA
CCCCTACGAAGGACACGACGAGCA -> CCCTACGAAGGACACGACGAGCAC
AAGATCAATATGCAATGCAGGGCC -> AGATCAATATGCAATGCAGGGCCT
GGGCGCACCCCTATACTCACAACA -> GGCGCACCCCTATACTCACAACAT
TGACTGGCTTCATTGGCGGAACAG -> GACTGGCTTCATTGGCGGAACAGT
GTAGTAGGAAGGCTAACATCATCC -> TAGTAGGAAGGCTAACATCATCCT
TTGTCAGTATATCAATTTCAATCA -> TGTCAGTATATCAATTTCAATCAA
TGGAACACGCATAAGAGGAAGGCA -> GGAACACGCATAAGAGGAAGGCAC
GCTTCATTGGCGGAACAGTGGGGT -> CTTCATTGGCGGAACAGTGGGGTG
GTTATACACGCAGTGGGTGAGACA -> TTATACACGCAGTGGGTGAGACAT
ATCAATATGCAATGCAGGGCCTTG -> TCAATATGCAATGCAGGGCCTTGG
CTTTTCTATGCGGTGCAGTAACTC -> TTTTCTATGCGGTGCAGTAACTCG
TCCTTCTAAAGCTGAGCCTATTCA -> CCTTCTAAAGCTGAGCCTATTCAG
AAAACAGACATTATCCTTTCTCGT -> AAACAGACATTATCCTTTCTCGTT
ATGAATGACCCTAACTACAGCTCC -> TGAATGACCCTAACTACAGCTCCC
TCCCGAGGACTAGATGCCGAGCGT -> CCCGAGGACTAGATGCCGAGCGTA
CAGGGCCTTGGCTAGGCACTATTA -> AGGGCCTTGGCTAGGCACTATTAC
GATTAATAACAGGGGTTACAGTAG -> ATTAATAACAGGGGTTACAGTAGA
AACTACAGCTCCCGCAGGCCTTTA -> ACTACAGCTCCCGCAGGCCTTTAA
GGCATTCGCAATTGATATTTTATT -> GCATTCGCAATTGATATTTTATTA
TACATTCTGTTCATAAAAAACGCT -> ACATTCTGTTCATAAAAAACGCTA
CATCATCCCGAGGACTAGATGCCG -> ATCATCCCGAGGACTAGATGCCGA
ATGTACGACGGCCACATTCGAAAG -> TGTACGACGGCCACATTCGAAAGA
TAACGCTATGACTGGCTTCATTGG -> AACGCTATGACTGGCTTCATTGGC
GCTTAGTCGCACAACTGCGATTTT -> CTTAGTCGCACAACTGCGATTTTG
TCCAGCTCGGGTTGATTGATTGCA -> CCAGCTCGGGTTGATTGATTGCAT
TGGATCGTAAATCCTAATCCTATT -> GGATCGTAAATCCTAATCCTATTA
GCCTATTCAGAGGATGCGCTTGGA -> CCTATTCAGAGGATGCGCTTGGAA
AGGAAGGCTAACATCATCCTCAGG -> GGAAGGCTAACATCATCCTCAGGT
TAGCAAGGATATAACCCCAGCGCG -> AGCAAGGATATAACCCCAGCGCGT
CCCTAAATGATGACCTATATGTAA -> CCTAAATGATGACCTATATGTAAC
ATTATGCAATTTGACTTATTCATC -> TTATGCAATTTGACTTATTCATCA
GTTATGCTGGATCGTAAATCCTAA -> TTATGCTGGATCGTAAATCCTAAT
CCTAACTACAGCTCCCGCAGGCCT -> CTAACTACAGCTCCCGCAGGCCTT
CAGCGGACAAAGGGTCCACGAGAA -> AGCGGACAAAGGGTCCACGAGAAC
GTACTAACAATTGAGTTATACACG -> TACTAACAATTGAGTTATACACGC
CCTATTAGCCCAGCGGACAAAGGG -> CTATTAGCCCAGCGGACAAAGGGT
AGTTGAAACTCTTAGATTTCGATT -> GTTGAAACTCTTAGATTTCGATTG
AACGCTATGACTGGCTTCATTGGC -> ACGCTATGACTGGCTTCATTGGCG
GCAGCACAACTAAGGTATTTATCC -> CAGCACAACTAAGGTATTTATCCT
GATCACCTAACGCTATGACTGGCT -> ATCACCTAACGCTATGACTGGCTT
ACCCCTATACTCACAACATTAAGA -> CCCCTATACTCACAACATTAAGAC
CTTTAGCCGTGGTCCACTTCTTTA -> TTTAGCCGTGGTCCACTTCTTTAG
CTAACATCATCCTCAGGTTGTGGG -> TAACATCATCCTCAGGTTGTGGGG
GTATTTAGAGTTGAAACTCTTAGA -> TATTTAGAGTTGAAACTCTTAGAT
AAAGAAGCTAAATTCAGATTCGAC -> AAGAAGCTAAATTCAGATTCGACC
CTAACAATTGAGTTATACACGCAG -> TAACAATTGAGTTATACACGCAGT
CCTACGAAGGACACGACGAGCACG -> CTACGAAGGACACGACGAGCACGT
GGTGCAGAACGGCATTCGCAATTG -> GTGCAGAACGGCATTCGCAATTGA
ACCAAACCGGTGGAACACGCATAA -> CCAAACCGGTGGAACACGCATAAG
CCCACAGACACATTAAAGTAGTGC -> CCACAGACACATTAAAGTAGTGCA
GCTAACGCGTCTCGCTCAGTTTCC -> CTAACGCGTCTCGCTCAGTTTCCC
TGTACATTCTGTTCATAAAAAACG -> GTACATTCTGTTCATAAAAAACGC
GCTTGGAAAATCTTGTTTTGTCAG -> CTTGGAAAATCTTGTTTTGTCAGT
CCTTGCCCGGAATGCCTGAATATG -> CTTGCCCGGAATGCCTGAATATGT
ACATTAAAGTAGTGCATAGAGTAA -> CATTAAAGTAGTGCATAGAGTAAC
GTCAGTATATCAATTTCAATCAAA -> TCAGTATATCAATTTCAATCAAAG
TTAGCCGTGGTCCACTTCTTTAGT -> TAGCCGTGGTCCACTTCTTTAGTA
TAATTGTCTAGCGAACCATCCTCA -> AATTGTCTAGCGAACCATCCTCAT
CGCGGCCTCGGCATTCTCAATCCA -> GCGGCCTCGGCATTCTCAATCCAG
GTGGTTGGGTAAGTGTGGAGACAG -> TGGTTGGGTAAGTGTGGAGACAGG
GAAAATCTTGTTTTGTCAGTATAT -> AAAATCTTGTTTTGTCAGTATATC
ATTATAGTTGGAACCAGTATATCG -> TTATAGTTGGAACCAGTATATCGA
TAAGACTACCGATTAATAACAGGG -> AAGACTACCGATTAATAACAGGGG
AGCAAGAACTGAGGCGAGACTGCA -> GCAAGAACTGAGGCGAGACTGCAT
AGGACACGACGAGCACGTCGGTCT -> GGACACGACGAGCACGTCGGTCTT
TTGTCAGCAGCACAACTAAGGTAT -> TGTCAGCAGCACAACTAAGGTATT
CGATTAATAACAGGGGTTACAGTA -> GATTAATAACAGGGGTTACAGTAG
CTCTTAGATTTCGATTGGAGTTGG -> TCTTAGATTTCGATTGGAGTTGGG
GGAAGGCACTATAGCTTCGAACGG -> GAAGGCACTATAGCTTCGAACGGG
TTCAGAGGATGCGCTTGGAAAATC -> TCAGAGGATGCGCTTGGAAAATCT
GAGAGGCGTGCCGTGCCTTGGCTA -> AGAGGCGTGCCGTGCCTTGGCTAA
AAGGACACGACGAGCACGTCGGTC -> AGGACACGACGAGCACGTCGGTCT
TCGACCGGATTAGTAATTGTCTAG -> CGACCGGATTAGTAATTGTCTAGC
CGTATGGACATGAATGACCCTAAC -> GTATGGACATGAATGACCCTAACT
ACGCTAAACTGTGGGGCCTCTGGT -> CGCTAAACTGTGGGGCCTCTGGTT
GGGTTACAGTAGAGGGGCTATTCT -> GGTTACAGTAGAGGGGCTATTCTC
GAGTAACTCCGGCCACCAAACCGG -> AGTAACTCCGGCCACCAAACCGGT
TAAAGCTGAGCCTATTCAGAGGAT -> AAAGCTGAGCCTATTCAGAGGATG
AGAAGCTGCCTCAAGTAGCAGGCT -> GAAGCTGCCTCAAGTAGCAGGCTG
AACGTATTCCTTCTAAAGCTGAGC -> ACGTATTCCTTCTAAAGCTGAGCC
CCAGAAGCTGCCTCAAGTAGCAGG -> CAGAAGCTGCCTCAAGTAGCAGGC
TGTAATTTGGGGTGGCACATGCTT -> GTAATTTGGGGTGGCACATGCTTA
GCCGAACGGCAACCACCTTTTTCG -> CCGAACGGCAACCACCTTTTTCGG
TCAAAGAGCCCTCATTAACGCGCG -> CAAAGAGCCCTCATTAACGCGCGG
AGGCTAACATCATCCTCAGGTTGT -> GGCTAACATCATCCTCAGGTTGTG
GTACGTCAAAGGCAAAGATAGATG -> TACGTCAAAGGCAAAGATAGATGG
CCTCTGGTTTTCCAGCTCGGGTTG -> CTCTGGTTTTCCAGCTCGGGTTGA
TCGGTCTTGTGAATCGCTGTTATG -> CGGTCTTGTGAATCGCTGTTATGA
CTACCGATTAATAACAGGGGTTAC -> TACCGATTAATAACAGGGGTTACA
TTATAGTTGGAACCAGTATATCGA -> TATAGTTGGAACCAGTATATCGAG
ACCATCCTCATAGCAAGGATATAA -> CCATCCTCATAGCAAGGATATAAC
GGGTAGCGTAACGGCCTTCAATGT -> GGTAGCGTAACGGCCTTCAATGTC
GAATATGTACGACGGCCACATTCG -> AATATGTACGACGGCCACATTCGA
GGCGGCTCGGTGCAATTCGTTTAT -> GCGGCTCGGTGCAATTCGTTTATG
ACATCATCCCGAGGACTAGATGCC -> CATCATCCCGAGGACTAGATGCCG
GCCGTGGTCCACTTCTTTAGTAAA -> CCGTGGTCCACTTCTTTAGTAAAG
CTCATTATAGTTGGAACCAGTATA -> TCATTATAGTTGGAACCAGTATAT
GCACAACTGCGATTTTGTCAGCAG -> CACAACTGCGATTTTGTCAGCAGC
ACGCGCAGGGATTGGTTGCGGGGC -> CGCGCAGGGATTGGTTGCGGGGCA
CAGAATTCTGGTCTTGGAGCGGCA -> AGAATTCTGGTCTTGGAGCGGCAA
TAAAGGCAGGTGTACTAAGGCGTG -> AAAGGCAGGTGTACTAAGGCGTGT
GGGGACTAGGACGGAATCGACGAC -> GGGACTAGGACGGAATCGACGACG
TAGGTGCTCTCTATAGCGCCCCCT -> AGGTGCTCTCTATAGCGCCCCCTA
GATTGATTGCATACTAGGTGCTCT -> ATTGATTGCATACTAGGTGCTCTC
AGATTGTGACGTTATTAGTCATCT -> GATTGTGACGTTATTAGTCATCTG
TATGTAACTCTTTCTGCGTTAGAC -> ATGTAACTCTTTCTGCGTTAGACA
AATGATGACCTATATGTAACTCTT -> ATGATGACCTATATGTAACTCTTT
TTGGGTAAGTGTGGAGACAGGCTC -> TGGGTAAGTGTGGAGACAGGCTCC
GAGTATCATTCAAAAGTTGTCAAC -> AGTATCATTCAAAAGTTGTCAACG
AGTAGGAAGGCTAACATCATCCTC -> GTAGGAAGGCTAACATCATCCTCA
AGGGGCTATTCTCTAGCAAGAACT -> GGGGCTATTCTCTAGCAAGAACTG
TCATAAAAAACGCTAAACTGTGGG -> CATAAAAAACGCTAAACTGTGGGG
AGTGGTTGGGTAAGTGTGGAGACA -> GTGGTTGGGTAAGTGTGGAGACAG
TAACGCGTCTCGCTCAGTTTCCCA -> AACGCGTCTCGCTCAGTTTCCCAC
GAGTTGGGACCGCCCACAGACACA -> AGTTGGGACCGCCCACAGACACAT
GCCTCAAGTAGCAGGCTGTTGAGC -> CCTCAAGTAGCAGGCTGTTGAGCA
ATTTAGAGTTGAAACTCTTAGATT -> TTTAGAGTTGAAACTCTTAGATTT
AGTGATCAACCCGCTACCAACAAA -> GTGATCAACCCGCTACCAACAAAT
GTAAAACAATCGCTCAACATTACA -> TAAAACAATCGCTCAACATTACAA
CAAATTAATATTGGACGCGCAGGG -> AAATTAATATTGGACGCGCAGGGA
CTGCGATTTTGTCAGCAGCACAAC -> TGCGATTTTGTCAGCAGCACAACT
TCGCGTTCGTCCTTGTCACATGAC -> CGCGTTCGTCCTTGTCACATGACT
GGAACAGTGGGGTGCAGAACGGCA -> GAACAGTGGGGTGCAGAACGGCAT
TTAGATTTCGATTGGAGTTGGGAC -> TAGATTTCGATTGGAGTTGGGACC
GACTCACCGGTCCATTCACCTTGT -> ACTCACCGGTCCATTCACCTTGTC
CTGTAGTAGGAAGGCTAACATCAT -> TGTAGTAGGAAGGCTAACATCATC
TTGACTTATTCATCAGTAACTTTG -> TGACTTATTCATCAGTAACTTTGT
AGAGGCGTGCCGTGCCTTGGCTAA -> GAGGCGTGCCGTGCCTTGGCTAAC
CCCCCGATCACCTAACGCTATGAC -> CCCCGATCACCTAACGCTATGACT
CAGCTCGGGTTGATTGATTGCATA -> AGCTCGGGTTGATTGATTGCATAC
CTCTGGTTTTCCAGCTCGGGTTGA -> TCTGGTTTTCCAGCTCGGGTTGAT
TGCGGTGCAGTAACTCGCGTTCGT -> GCGGTGCAGTAACTCGCGTTCGTC
CGAGAGGCGTGCCGTGCCTTGGCT -> GAGAGGCGTGCCGTGCCTTGGCTA
ACTAGGACGGAATCGACGACGAGA -> CTAGGACGGAATCGACGACGAGAG
AGCGTACGTCAAAGGCAAAGATAG -> GCGTACGTCAAAGGCAAAGATAGA
TCGACGACGAGAGGCGTGCCGTGC -> CGACGACGAGAGGCGTGCCGTGCC
TGTCAGTATATCAATTTCAATCAA -> GTCAGTATATCAATTTCAATCAAA
CTAAGGCGTGTTAGCCAAAGTAGT -> TAAGGCGTGTTAGCCAAAGTAGTT
ACAACTAAGGTATTTATCCTCCCC -> CAACTAAGGTATTTATCCTCCCCT
AACGGCATTCGCAATTGATATTTT -> ACGGCATTCGCAATTGATATTTTA
GCATCCTTGCCCGGAATGCCTGAA -> CATCCTTGCCCGGAATGCCTGAAT
CTTTCTCGTTGCTGCCATGGAGCG -> TTTCTCGTTGCTGCCATGGAGCGT
CAGCAGCACAACTAAGGTATTTAT -> AGCAGCACAACTAAGGTATTTATC
GCTACCAACAAATTAATATTGGAC -> CTACCAACAAATTAATATTGGACG
GCCTTCAATGTCGTGGGGACTAGG -> CCTTCAATGTCGTGGGGACTAGGA
CTCAAGTAGCAGGCTGTTGAGCAA -> TCAAGTAGCAGGCTGTTGAGCAAT
GCCCAGCGGACAAAGGGTCCACGA -> CCCAGCGGACAAAGGGTCCACGAG
CGCCCCCTAAATGATGACCTATAT -> GCCCCCTAAATGATGACCTATATG
GCGCGGCCTCGGCATTCTCAATCC -> CGCGGCCTCGGCATTCTCAATCCA
AAGGTGTTGGTCTTTTCTATGCGG -> AGGTGTTGGTCTTTTCTATGCGGT
TGGGAGTGGTTGGGTAAGTGTGGA -> GGGAGTGGTTGGGTAAGTGTGGAG
GTGGGGACTAGGACGGAATCGACG -> TGGGGACTAGGACGGAATCGACGA
ATTGGACGCGCAGGGATTGGTTGC -> TTGGACGCGCAGGGATTGGTTGCG
AGCGATAATGGCTCTGATCTGACT -> GCGATAATGGCTCTGATCTGACTT
GTAACGGCCTTCAATGTCGTGGGG -> TAACGGCCTTCAATGTCGTGGGGA
TATCCTTTCTCGTTGCTGCCATGG -> ATCCTTTCTCGTTGCTGCCATGGA
TTATGCAATTTGACTTATTCATCA -> TATGCAATTTGACTTATTCATCAG
CAGCGATAATGGCTCTGATCTGAC -> AGCGATAATGGCTCTGATCTGACT
CTAACGCTATGACTGGCTTCATTG -> TAACGCTATGACTGGCTTCATTGG
AGTTTCCCACTTATTTAAGACTAC -> GTTTCCCACTTATTTAAGACTACC
AACACGCATAAGAGGAAGGCACTA -> ACACGCATAAGAGGAAGGCACTAT
AGAACGGCATTCGCAATTGATATT -> GAACGGCATTCGCAATTGATATTT
GCATTCTCAATCCAGAAGCTGCCT -> CATTCTCAATCCAGAAGCTGCCTC
CCCTATACTCACAACATTAAGACT -> CCTATACTCACAACATTAAGACTA
GGAGGTAATAAAACAGACATTATC -> GAGGTAATAAAACAGACATTATCC
GCGCCCCCTAAATGATGACCTATA -> CGCCCCCTAAATGATGACCTATAT
GTACGACTGGGCGGCTCGGTGCAA -> TACGACTGGGCGGCTCGGTGCAAT
AACGGGAATCACTGCTAGTAGTAA -> ACGGGAATCACTGCTAGTAGTAAC
GGACTTTTCCCCCCCTCAAGGCCT -> GACTTTTCCCCCCCTCAAGGCCTG
AAGATAGATGGTTGAGGGGCCCGA -> AGATAGATGGTTGAGGGGCCCGAC
GAGTTATACACGCAGTGGGTGAGA -> AGTTATACACGCAGTGGGTGAGAC
TGAGGCGAGACTGCATGACATCAT -> GAGGCGAGACTGCATGACATCATC
TGCATAGAGTAACTCCGGCCACCA -> GCATAGAGTAACTCCGGCCACCAA
CGAGAACGGGCGCACCCCTATACT -> GAGAACGGGCGCACCCCTATACTC
ATCCCGAGGACTAGATGCCGAGCG -> TCCCGAGGACTAGATGCCGAGCGT
GACGGCCACATTCGAAAGAAGCTA -> ACGGCCACATTCGAAAGAAGCTAA
TAGTCATCTGGTTGTGTTACTGGG -> AGTCATCTGGTTGTGTTACTGGGA
CGGAACAGTGGGGTGCAGAACGGC -> GGAACAGTGGGGTGCAGAACGGCA
AATCCAGAAGCTGCCTCAAGTAGC -> ATCCAGAAGCTGCCTCAAGTAGCA
GTTGATTGATTGCATACTAGGTGC -> TTGATTGATTGCATACTAGGTGCT
CTCGTTGCTGCCATGGAGCGTATG -> TCGTTGCTGCCATGGAGCGTATGG
GCTAAACTGTGGGGCCTCTGGTTT -> CTAAACTGTGGGGCCTCTGGTTTT
GGAATTATGCAATTTGACTTATTC -> GAATTATGCAATTTGACTTATTCA
CATCCTCAGGTTGTGGGGTCACCT -> ATCCTCAGGTTGTGGGGTCACCTT
CATAGCAAGGATATAACCCCAGCG -> ATAGCAAGGATATAACCCCAGCGC
GGCCCGACTCATAAAGGCAGGTGT -> GCCCGACTCATAAAGGCAGGTGTA
CGATAATGGCTCTGATCTGACTTT -> GATAATGGCTCTGATCTGACTTTA
GAGGCGTGCCGTGCCTTGGCTAAC -> AGGCGTGCCGTGCCTTGGCTAACG
TAGTCGCACAACTGCGATTTTGTC -> AGTCGCACAACTGCGATTTTGTCA
TGCGACCCCTTACCAATCTAGAAG -> GCGACCCCTTACCAATCTAGAAGT
CAAGGTGTTGGTCTTTTCTATGCG -> AAGGTGTTGGTCTTTTCTATGCGG
TCGTTGCTGCCATGGAGCGTATGG -> CGTTGCTGCCATGGAGCGTATGGA
GTAGTAACAAGTACGACTGGGCGG -> TAGTAACAAGTACGACTGGGCGGC
TCATTCAAAAGTTGTCAACGTATT -> CATTCAAAAGTTGTCAACGTATTC
TCGTTTATGTCGTGGGTAGCGTAA -> CGTTTATGTCGTGGGTAGCGTAAC
ATCACCTAACGCTATGACTGGCTT -> TCACCTAACGCTATGACTGGCTTC
TAGCCAAAGTAGTTGGGAGTGGTT -> AGCCAAAGTAGTTGGGAGTGGTTG
TTGATTGATTGCATACTAGGTGCT -> TGATTGATTGCATACTAGGTGCTC
CGCTAAACTGTGGGGCCTCTGGTT -> GCTAAACTGTGGGGCCTCTGGTTT
TTCCTCATTATAGTTGGAACCAGT -> TCCTCATTATAGTTGGAACCAGTA
TGCAGTAACTCGCGTTCGTCCTTG -> GCAGTAACTCGCGTTCGTCCTTGT
CGGCAACCACCTTTTTCGGAGTTG -> GGCAACCACCTTTTTCGGAGTTGG
CGGAATCGACGACGAGAGGCGTGC -> GGAATCGACGACGAGAGGCGTGCC
GGGAATCACTGCTAGTAGTAACAA -> GGAATCACTGCTAGTAGTAACAAG
AAGGCAAAGATAGATGGTTGAGGG -> AGGCAAAGATAGATGGTTGAGGGG
ACCGCAGTACTAACAATTGAGTTA -> CCGCAGTACTAACAATTGAGTTAT
GTCGTGGGTAGCGTAACGGCCTTC -> TCGTGGGTAGCGTAACGGCCTTCA
TTATGTCGTGGGTAGCGTAACGGC -> TATGTCGTGGGTAGCGTAACGGCC
ACTCTTTCTGCGTTAGACAGCGTT -> CTCTTTCTGCGTTAGACAGCGTTA
GCAGTAACTCGCGTTCGTCCTTGT -> CAGTAACTCGCGTTCGTCCTTGTC
GTAACAGCGATAATGGCTCTGATC -> TAACAGCGATAATGGCTCTGATCT
ACTAACAATTGAGTTATACACGCA -> CTAACAATTGAGTTATACACGCAG
GGCGCACCCCTATACTCACAACAT -> GCGCACCCCTATACTCACAACATT
ATGCTGGATCGTAAATCCTAATCC -> TGCTGGATCGTAAATCCTAATCCT
CCCGCTACCAACAAATTAATATTG -> CCGCTACCAACAAATTAATATTGG
TTAGCCCAGCGGACAAAGGGTCCA -> TAGCCCAGCGGACAAAGGGTCCAC
GTATTTATCCTCCCCTACGAAGGA -> TATTTATCCTCCCCTACGAAGGAC
CTCAGGTTGTGGGGTCACCTTTAA -> TCAGGTTGTGGGGTCACCTTTAAC
AGCCCAGCGGACAAAGGGTCCACG -> GCCCAGCGGACAAAGGGTCCACGA
AAGACTATGTATTTAGAGTTGAAA -> AGACTATGTATTTAGAGTTGAAAC
CGCAGTGGGTGAGACATCGAAAGT -> GCAGTGGGTGAGACATCGAAAGTC
TGTAGTAGGAAGGCTAACATCATC -> GTAGTAGGAAGGCTAACATCATCC
CGTAACAGCGATAATGGCTCTGAT -> GTAACAGCGATAATGGCTCTGATC
ACAGTGTACATTCTGTTCATAAAA -> CAGTGTACATTCTGTTCATAAAAA
AAGGCGTGTTAGCCAAAGTAGTTG -> AGGCGTGTTAGCCAAAGTAGTTGG
TCATAAAGGCAGGTGTACTAAGGC -> CATAAAGGCAGGTGTACTAAGGCG
CGTTGCTGCCATGGAGCGTATGGA -> GTTGCTGCCATGGAGCGTATGGAC
